6 6 6 6 8 8 8 8 8 8 8 8 8 8 8 8 8 8 8 8 8 8 8 8 8 8 8 8 8 8 8 8 8 8 8 8 8 8 8 8
6 6 6 6 8 8 8 8 8 8 8 8 8 8 8 8 8 8 8 8 8 8 8 8 8 8 8 8 8 8 8 8 8 8 8 8 8 8 8 8
6 6 6 6 8 8 8 8 8 8 8 8 8 8 8 8 8 8 8 8 8 8 8 8 8 8 8 8 8 8 8 8 8 8 8 8 8 8 8 8
6 6 6 6 8 8 8 8 8 8 8 8 8 8 8 8 8 8 8 8 8 8 8 8 8 8 8 8 2 2 2 2 8 8 8 8 8 8 8 8
6 6 6 6 8 8 8 8 8 8 8 8 8 8 8 8 8 8 8 8 8 8 8 8 8 8 8 8 2 2 2 2 8 8 8 8 8 8 8 8
6 6 6 6 8 8 8 8 8 8 8 8 8 8 8 2 2 2 2 8 8 8 8 8 8 8 8 2 2 2 2 8 8 8 8 8 8 8 8 8
6 6 6 6 8 8 8 8 8 8 8 8 8 8 8 8 2 3 3 2 8 8 8 8 8 8 8 8 8 8 8 8 8 8 8 8 8 8 8 8
6 6 6 6 8 8 8 8 8 8 8 8 8 8 8 8 2 2 2 2 8 8 8 8 8 8 8 8 8 8 8 8 8 8 8 8 8 8 8 8
6 6 6 6 8 8 8 8 8 8 8 8 8 8 8 8 8 8 8 8 8 8 8 8 8 8 8 8 8 8 8 8 8 8 8 8 8 8 8 8
6 6 6 6 8 8 8 8 8 8 8 8 8 8 8 8 8 8 8 8 8 2 2 3 3 3 2 2 8 8 8 8 8 8 8 8 8 8 8 8
6 6 6 6 8 8 8 8 8 8 8 8 8 8 8 8 8 8 8 8 2 2 5 5 5 5 5 2 2 8 8 8 8 8 8 8 8 8 8 8
6 6 6 6 8 8 8 8 8 8 8 8 8 8 8 8 8 8 8 2 2 5 5 5 5 5 5 5 2 2 8 8 8 8 8 8 8 8 8 8
6 6 6 6 8 8 8 8 8 8 8 8 8 8 8 8 8 8 8 2 5 5 9 9 9 9 9 5 5 2 8 8 8 8 8 8 8 8 8 8
6 6 6 6 8 8 8 8 8 8 8 8 8 8 8 8 8 8 8 2 5 5 9 9 9 9 9 5 5 2 8 8 8 8 8 8 8 8 8 8
6 6 6 6 8 8 8 8 2 2 2 8 8 8 8 8 8 8 8 2 5 5 9 9 9 9 9 5 5 2 8 8 8 8 8 8 8 8 8 8
6 6 6 6 8 8 8 8 2 3 2 8 8 8 8 8 8 8 8 2 2 5 5 0 0 0 5 5 2 2 8 8 8 8 8 8 8 8 8 8
6 6 6 6 8 8 8 8 2 2 2 8 8 8 8 8 8 8 8 2 2 2 2 2 0 2 2 2 2 2 8 8 8 8 8 8 8 8 8 8
6 6 6 6 8 8 8 8 8 8 8 8 8 8 8 8 8 8 8 8 8 8 8 8 1 8 8 8 8 8 8 8 8 8 8 8 8 8 8 8
6 6 6 6 8 8 8 8 8 8 8 8 8 8 8 8 8 8 8 8 8 8 8 8 0 8 8 8 8 8 8 8 8 8 8 8 8 8 8 8
6 6 6 6 8 8 8 8 8 8 8 8 3 2 2 2 8 8 8 8 8 8 8 8 0 8 8 8 8 8 8 8 8 8 8 8 8 8 8 8
6 6 6 6 8 8 8 8 8 8 8 8 3 2 6 6 8 0 0 0 0 0 1 0 0 0 0 0 0 0 0 0 8 8 8 8 8 8 8 8
6 6 6 6 8 8 8 8 8 8 8 8 3 2 6 6 8 0 0 0 1 0 0 0 0 0 0 1 0 0 0 1 0 8 8 8 8 8 8 1
6 6 6 6 8 8 8 8 8 8 8 8 8 8 6 6 8 0 0 8 8 8 8 8 8 8 8 8 8 8 8 0 0 8 8 8 8 8 8 6
6 6 6 6 8 8 8 8 8 8 8 8 8 8 6 6 8 0 1 8 8 8 8 8 8 8 8 8 8 8 8 0 0 8 8 8 8 8 8 6
6 6 6 6 8 8 8 8 8 8 8 8 8 8 6 6 6 6 6 8 8 3 2 2 2 6 6 6 3 2 2 2 2 8 8 8 8 8 8 6
6 6 6 6 8 8 8 8 8 8 8 8 8 8 6 6 6 6 6 8 8 2 2 2 2 6 6 6 6 6 2 2 2 8 8 8 8 8 8 6
6 6 6 6 8 8 8 8 8 8 8 8 8 8 8 8 8 8 8 8 2 1 2 2 8 8 6 6 6 2 2 2 2 8 8 8 8 8 8 6
6 6 6 6 8 8 8 8 8 8 8 8 8 8 8 8 8 2 2 2 2 2 2 2 2 2 6 6 2 2 2 2 2 8 8 8 8 8 8 6
6 6 6 6 8 8 8 8 8 8 8 8 8 8 8 8 8 2 2 2 2 2 2 3 3 8 2 3 3 2 2 2 3 8 8 8 8 8 8 6
6 6 6 6 8 8 8 8 8 8 8 8 8 8 8 8 8 2 2 2 2 2 2 2 1 3 2 3 2 2 3 3 2 8 8 8 8 8 8 6
6 6 6 6 8 8 8 8 8 8 8 8 8 8 8 8 8 2 2 3 2 0 0 0 0 0 2 2 3 2 0 0 1 8 8 8 8 8 8 6
6 6 6 6 8 8 8 8 8 8 8 8 8 8 8 8 8 2 1 0 0 0 0 0 0 0 0 2 2 2 0 0 2 8 8 8 8 8 8 6
6 6 6 6 8 8 8 8 8 8 8 8 8 8 8 8 8 2 0 0 0 0 1 0 0 0 0 2 2 2 2 2 2 8 8 8 8 8 8 6
6 6 6 6 8 8 8 8 8 8 8 8 8 8 8 8 8 2 0 0 1 0 0 0 0 0 0 2 3 3 3 3 2 8 8 8 8 8 8 6
6 6 6 6 8 8 8 8 8 8 8 8 8 8 8 8 8 2 2 0 0 0 1 0 0 2 2 2 3 2 2 2 2 8 8 8 8 8 8 6
6 6 6 6 8 8 8 8 8 8 8 8 8 8 8 8 8 2 3 2 3 0 0 0 3 2 3 3 3 2 3 3 3 8 8 8 8 8 8 6
6 6 6 6 8 8 8 8 8 8 8 8 8 8 8 8 8 0 0 1 2 3 2 2 2 2 0 0 1 2 2 2 2 8 8 8 8 8 8 6
6 6 6 6 8 8 8 8 8 8 8 8 8 8 8 8 8 1 7 1 2 2 2 2 2 0 0 7 0 0 2 1 0 8 8 8 8 8 8 6
6 6 6 6 8 8 8 8 8 8 8 8 8 8 8 8 8 7 7 0 0 1 0 0 0 1 7 7 7 0 0 1 7 8 8 8 8 8 8 6
6 6 6 6 6 6 6 6 6 6 6 7 7 7 7 7 7 7 7 7 7 7 7 7 7 7 7 7 7 7 7 7 7 7 7 7 7 7 7 6
6 6 6 6 6 6 6 6 6 6 6 7 7 6 7 7 7 7 7 7 7 7 7 6 7 7 7 6 7 7 7 7 7 6 7 7 6 7 7 6
6 6 6 6 6 6 6 6 6 6 6 7 6 6 6 7 7 7 7 7 7 6 6 6 6 7 7 7 6 6 7 6 6 6 6 6 6 6 6 6
6 6 6 6 6 6 6 6 6 6 6 6 6 6 6 6 6 6 6 6 6 6 6 6 6 6 7 6 6 6 6 6 6 6 6 6 6 6 6 6
6 6 6 6 6 6 6 6 6 6 6 6 6 6 6 6 6 6 6 6 6 6 6 6 6 6 6 6 6 6 6 6 6 6 6 6 6 6 6 6
6 6 6 6 6 6 6 6 6 6 6 6 6 6 6 6 6 6 6 6 6 6 6 6 6 6 6 6 6 6 6 6 6 6 6 6 6 6 6 6
6 6 6 6 6 6 6 6 6 6 6 6 6 6 6 6 6 6 6 6 6 6 6 6 6 6 6 6 6 6 6 6 6 6 6 6 6 6 6 6
6 6 6 6 6 6 6 6 6 6 6 6 6 6 6 6 6 6 6 6 6 6 6 6 6 6 6 6 6 6 6 6 6 6 6 6 6 6 6 6
6 6 6 6 6 6 6 6 6 6 6 6 6 6 6 6 6 6 6 6 6 6 6 6 6 6 6 6 6 6 6 6 6 6 6 6 6 6 6 6
6 6 6 6 6 6 6 6 6 6 6 6 6 6 6 6 6 6 6 6 6 6 6 6 6 6 6 6 6 6 6 6 6 6 6 6 6 6 6 6
6 6 6 6 6 6 6 6 6 6 6 6 6 6 6 6 6 6 6 6 6 6 6 6 6 6 6 6 6 6 6 6 6 6 6 6 6 6 6 6