6 6 6 6 6 6 6 6 6 6 6 6 6 6 6 6 6 6 6 6 6 6 6 6 6 6 6 6 6 6 6 6 6 6 6 6 6 6 6 6 6 6 6 6 6 6 6 6 6 6
6 8 2 4 3 5 4 3 4 5 3 4 2 4 3 3 2 4 4 2 4 3 4 4 4 4 5 4 2 2 3 4 4 4 5 5 4 3 4 4 3 4 4 4 4 5 3 5 3 6
6 3 4 5 3 3 3 2 5 3 4 2 2 3 5 4 4 2 5 4 4 3 4 3 4 4 4 3 4 4 5 5 4 4 5 5 5 4 4 5 5 5 4 4 4 3 4 4 4 6
6 4 3 4 2 4 4 4 2 4 3 3 5 3 2 4 3 4 3 4 4 5 5 5 5 4 4 5 4 4 3 5 4 4 4 3 4 4 4 3 3 5 4 5 4 5 4 4 5 6
6 3 3 2 2 4 4 4 3 4 4 4 3 2 4 4 4 5 4 3 4 3 3 4 4 4 4 4 4 5 5 4 4 3 4 5 3 3 4 4 4 3 5 4 4 5 3 4 5 6
6 3 4 3 4 4 3 3 4 4 4 4 4 3 4 4 4 4 4 5 4 3 3 4 4 4 5 4 4 4 3 4 5 5 5 4 5 4 5 4 4 5 4 4 4 4 3 4 4 6
6 3 4 5 5 4 4 4 3 4 4 4 4 4 3 3 3 4 5 4 4 4 4 3 4 4 4 4 4 4 3 3 4 4 4 5 5 4 4 4 4 4 4 4 5 3 3 4 4 6
6 4 4 5 4 4 4 4 3 3 4 4 4 4 3 3 3 5 4 4 3 4 3 3 4 4 4 3 3 3 4 4 4 5 4 3 3 4 4 4 4 4 4 4 4 4 4 3 4 6
6 4 4 5 5 5 3 4 5 3 4 4 3 4 3 5 5 4 5 3 3 4 4 4 4 4 4 4 4 4 4 4 4 4 4 4 4 3 5 3 4 5 4 4 5 5 4 5 4 6
6 3 5 5 3 3 4 4 4 3 4 4 4 4 4 4 4 4 4 4 5 5 4 3 4 4 4 4 3 3 5 4 4 4 4 4 4 4 4 4 4 4 4 3 3 4 3 4 4 6
6 4 4 4 3 3 4 5 3 3 4 3 3 4 4 4 4 5 4 4 5 3 3 4 4 4 4 5 4 3 5 4 4 4 4 3 4 3 4 4 3 5 4 4 5 4 4 5 3 6
6 3 3 3 4 3 5 4 4 4 4 4 5 4 4 3 3 4 3 4 4 4 3 4 4 4 4 4 4 5 3 3 3 5 3 3 3 5 3 4 4 4 4 5 5 4 4 4 4 6
6 3 3 4 4 5 5 5 4 4 4 4 4 4 4 4 3 4 3 3 4 5 4 4 4 4 4 4 3 4 4 4 4 4 3 3 5 4 4 4 4 3 4 5 4 3 5 4 4 6
6 3 4 4 5 5 4 5 5 4 3 3 4 4 4 4 4 3 4 4 3 4 4 4 3 3 4 4 4 4 4 4 4 4 4 4 4 4 4 4 4 3 3 4 3 4 4 4 4 6
6 3 3 4 3 4 5 4 4 4 4 4 4 4 4 4 4 4 4 4 4 4 3 4 4 4 4 4 3 3 4 4 4 3 4 4 4 4 5 4 4 4 3 4 3 4 4 4 5 6
6 5 4 4 4 4 5 3 3 3 3 3 4 4 4 4 4 3 4 4 4 4 4 4 4 4 4 3 3 3 4 4 3 4 3 4 4 4 4 5 4 4 4 3 4 5 4 3 5 6
6 4 3 4 4 4 4 5 5 3 4 4 4 4 4 4 4 4 4 4 4 3 4 4 4 4 4 3 3 4 4 4 4 4 4 4 4 4 4 4 5 4 4 4 4 4 4 4 4 6
6 4 3 3 4 4 4 4 3 4 4 4 4 4 4 3 4 4 4 4 4 4 4 4 4 4 4 3 4 4 4 4 4 3 4 4 4 4 4 4 3 4 4 4 4 4 4 3 4 6
6 4 4 4 5 4 4 4 4 4 4 4 4 4 4 4 4 4 3 4 4 4 3 4 4 4 4 4 4 3 4 4 4 4 4 4 4 4 4 3 3 4 4 3 4 4 4 4 4 6
6 3 5 4 4 4 4 4 3 4 4 4 4 4 4 4 4 4 4 4 4 4 4 3 3 4 4 4 4 4 4 4 4 4 4 4 4 4 4 4 3 3 4 3 4 3 4 4 5 6
6 4 3 4 4 4 4 3 4 4 4 4 4 4 4 4 4 4 4 4 4 4 4 3 4 4 4 4 4 4 4 4 4 4 4 4 4 4 4 4 4 4 4 3 4 3 3 4 5 6
6 3 4 3 3 4 3 4 4 4 3 3 4 4 4 4 4 3 3 3 4 4 4 4 4 4 4 3 4 3 3 3 4 4 4 4 4 4 4 3 3 3 3 3 4 4 3 3 3 6
6 3 4 4 5 5 4 4 4 4 4 3 4 4 4 3 4 4 4 4 4 4 4 4 4 4 4 3 4 3 3 4 4 3 4 4 3 4 4 4 4 4 4 4 4 4 4 4 4 6
6 4 4 4 4 5 3 5 4 3 4 3 3 4 3 4 4 4 3 3 4 4 4 4 3 4 4 4 3 3 3 3 4 4 3 4 4 4 4 4 3 3 3 4 4 3 4 4 4 6
6 4 3 4 4 4 4 4 3 3 3 4 4 3 4 4 4 3 3 3 4 4 4 4 4 4 4 4 4 4 4 4 3 4 4 4 4 4 4 4 4 3 4 4 4 4 4 3 4 6
6 5 4 4 4 4 4 4 4 4 3 4 4 4 3 4 4 4 4 3 4 4 4 4 4 4 4 4 4 4 4 4 4 4 4 4 4 4 4 4 4 4 4 3 3 4 4 4 4 6
6 4 5 4 4 4 4 4 4 4 4 4 4 4 4 4 4 4 4 4 4 4 4 4 4 4 4 4 4 4 4 4 4 4 4 4 4 4 4 4 4 4 4 4 4 4 4 4 4 6
6 4 4 4 4 4 4 4 4 4 4 4 4 4 4 4 4 4 4 4 4 4 4 4 4 4 4 4 4 4 4 4 4 4 4 4 4 4 4 4 4 4 4 4 4 4 4 4 4 6
6 6 6 6 6 6 6 6 6 6 6 6 6 6 6 6 6 6 6 6 6 6 6 6 6 6 6 6 6 6 6 6 6 6 6 6 6 6 6 6 6 6 6 6 6 6 6 6 6 6
