4 4 4 4 4 4 4 4 4 4 4 4 4 4 4 4 4 4 4 4 4 4 4 4 4 4 4 4 4 4 4 4 4 4 4 4 4 4 4 4 4 4 4 4 4 4 4 4 4 4 4 4 4 4 4 4 4 4 4 4 4 4 4 4 4 4 4 4 4 4 4 4 4 4 4 4 4 4 4 4 4 4 4 4 4 4 4 4 4 4 4 4 4 4 4 4 4 4 4 4
4 9 3 3 3 2 8 8 8 8 8 8 8 8 8 8 8 8 8 8 8 3 2 2 3 3 2 8 8 8 8 8 8 8 3 2 8 8 8 8 8 8 8 8 8 8 8 8 8 8 8 8 8 8 8 8 8 8 8 2 3 2 3 2 2 8 8 8 8 8 8 8 8 8 8 8 8 8 8 8 8 8 8 8 3 2 8 8 8 8 8 8 8 8 8 8 8 8 2 4
4 8 8 8 8 3 3 3 8 8 8 8 8 8 8 8 8 8 8 2 2 3 3 3 3 3 3 8 8 8 8 8 8 8 2 3 8 8 8 8 8 8 8 8 8 8 8 8 8 8 8 8 8 8 8 8 8 8 8 8 8 8 8 8 8 8 8 8 8 8 8 8 8 8 8 8 8 8 8 8 8 8 8 8 3 3 8 8 8 8 8 8 8 8 8 2 2 2 2 4
4 8 8 8 8 8 8 3 8 8 8 8 8 8 8 8 8 8 2 2 2 8 8 8 8 8 3 8 8 8 8 8 8 8 2 2 8 8 8 8 8 8 8 8 8 8 8 8 8 8 8 8 8 8 8 8 8 8 8 8 8 7 7 7 8 8 8 8 8 8 8 8 8 8 8 8 8 8 8 8 8 8 8 8 8 8 8 8 8 8 8 8 8 8 8 2 2 2 2 4
4 8 8 8 8 8 8 2 2 2 2 2 2 2 2 2 2 3 2 2 2 8 8 8 8 8 2 2 8 8 8 8 8 8 8 2 8 8 2 8 2 8 8 2 2 2 8 8 8 8 8 8 8 8 8 8 8 8 7 7 7 7 6 7 7 7 7 8 8 8 8 8 8 8 8 8 8 8 8 8 8 8 8 8 8 8 8 8 8 8 8 8 8 8 8 2 2 2 2 4
4 8 8 8 8 8 8 8 8 8 8 8 8 8 8 8 8 8 2 2 2 8 8 8 8 8 2 3 2 2 2 2 2 3 2 2 8 3 2 2 2 3 8 2 2 2 8 8 8 8 8 8 8 8 8 8 8 7 7 6 6 6 6 6 6 6 7 7 8 8 8 8 8 8 8 8 8 8 8 8 8 8 8 8 8 2 2 2 3 2 3 2 3 2 3 2 2 2 2 4
4 8 8 8 8 8 8 8 8 8 8 8 8 8 8 8 8 8 8 2 8 8 8 8 8 8 8 8 2 3 2 2 2 3 2 2 2 3 2 3 2 2 2 2 2 2 8 8 8 8 8 8 8 8 8 8 7 7 6 6 6 6 6 6 6 6 6 7 7 8 8 8 8 8 8 8 8 8 8 8 8 8 8 2 2 2 2 2 3 2 3 2 3 2 3 2 2 2 2 4
4 8 8 8 8 8 8 8 8 8 8 8 8 8 8 8 8 8 8 8 8 8 8 8 8 8 8 8 8 8 8 8 8 8 2 3 2 3 2 2 2 3 2 2 2 2 8 8 8 8 8 8 8 8 8 8 7 6 6 6 6 6 6 6 6 6 6 6 7 8 8 8 8 8 8 8 8 8 8 8 8 8 8 2 2 2 2 2 3 2 3 2 3 2 3 2 8 2 2 4
4 8 8 8 8 8 8 8 8 3 3 8 8 8 8 8 8 8 8 8 8 8 8 8 8 8 8 8 8 8 8 8 8 8 2 2 2 3 8 2 8 2 2 2 2 2 8 8 8 8 8 2 2 2 3 8 7 6 6 6 6 6 6 6 6 6 6 6 7 8 8 8 8 8 8 8 8 8 8 8 8 8 8 2 2 2 2 2 3 2 3 2 3 2 3 2 8 2 2 4
4 8 8 8 8 8 8 8 8 2 3 2 2 2 3 2 3 8 8 8 8 8 8 8 8 8 8 8 8 8 8 8 8 8 2 8 2 8 8 2 8 8 2 8 8 8 8 8 8 8 8 8 8 8 8 7 7 6 6 6 6 6 6 6 6 6 6 6 7 7 8 8 8 8 8 8 8 8 8 8 8 8 8 2 2 2 2 2 3 2 3 2 3 2 3 2 8 2 2 4
4 8 8 8 8 8 8 8 8 3 2 2 3 2 2 3 2 8 8 8 8 8 8 8 8 8 8 8 8 8 8 8 8 8 8 8 8 8 8 3 8 8 8 8 8 8 8 8 8 8 8 8 8 8 8 7 6 6 6 6 6 6 9 6 6 6 6 6 6 7 8 8 8 8 8 8 8 8 8 8 8 8 8 2 2 8 8 8 8 8 8 8 8 8 8 8 8 2 2 4
4 8 8 8 8 8 8 8 8 2 3 2 2 8 2 3 3 8 8 8 8 8 8 8 8 8 8 8 8 8 8 8 8 8 8 8 8 8 8 2 8 8 8 8 8 8 8 8 8 8 8 8 8 8 8 7 7 6 6 6 6 6 9 6 6 6 6 6 7 7 8 8 8 8 8 8 8 8 8 8 8 8 7 7 7 8 8 8 8 8 8 8 8 8 8 8 8 2 2 4
4 2 8 8 8 8 8 8 8 8 8 2 2 2 2 2 2 8 8 8 8 8 8 8 8 8 8 8 8 8 8 8 8 8 8 8 8 8 8 3 8 8 8 8 8 8 8 8 8 8 8 8 8 8 8 8 7 6 6 6 6 6 9 6 6 6 6 6 7 8 8 8 8 8 8 8 8 8 8 7 7 7 7 6 7 7 7 7 8 8 8 8 8 8 8 8 8 2 2 4
4 2 8 8 8 8 8 8 8 8 8 8 2 2 8 2 8 8 8 8 8 8 8 8 8 8 8 8 8 8 8 8 8 8 8 8 8 8 8 3 8 8 8 8 8 8 8 8 8 8 8 8 8 8 8 8 7 6 6 6 6 6 9 6 6 6 6 6 7 8 8 8 8 8 8 8 8 8 7 7 6 6 6 6 6 6 6 7 7 8 8 8 8 8 8 8 8 2 2 4
4 8 8 8 8 8 8 8 8 8 8 8 2 2 8 8 8 8 8 8 8 8 8 8 8 8 8 8 8 8 8 8 8 8 8 8 8 8 8 2 8 8 8 8 8 8 8 8 8 8 8 8 8 8 8 8 7 7 6 6 6 6 9 6 6 6 6 7 7 8 8 8 8 8 8 8 8 8 7 6 6 6 6 6 6 6 6 6 7 8 8 8 8 8 8 8 8 2 2 4
4 8 8 8 8 8 8 8 8 8 8 8 2 2 8 8 8 8 8 8 8 5 5 4 5 8 8 8 8 8 8 8 8 8 8 8 8 8 8 2 8 8 8 8 8 8 8 8 8 8 8 8 8 8 8 8 8 7 7 6 6 6 9 6 6 6 7 7 8 8 8 8 8 8 8 8 8 8 7 6 6 6 6 6 6 6 6 6 7 8 8 8 8 8 8 8 8 2 2 4
4 8 8 8 8 8 8 8 8 8 8 8 2 2 8 8 8 8 8 8 1 0 0 1 4 8 8 8 8 8 8 8 8 8 8 8 8 8 8 2 8 8 8 8 8 8 8 8 8 8 8 8 8 8 8 8 8 8 7 7 7 7 0 7 7 7 7 8 8 8 8 8 8 8 8 8 8 7 7 6 6 6 6 6 6 6 6 6 7 7 8 8 8 8 8 8 8 2 2 4
4 8 8 8 8 8 8 8 8 8 8 8 2 2 8 5 4 5 4 5 0 5 9 9 5 8 8 8 8 8 8 8 8 8 8 8 8 8 8 3 8 8 8 8 8 8 8 8 8 8 8 8 8 8 8 8 8 8 8 8 8 7 0 7 8 3 3 8 8 8 8 8 8 8 8 8 8 7 6 6 6 6 6 6 6 6 6 6 6 7 8 8 8 8 8 8 8 2 2 4
4 8 8 8 8 8 8 8 8 8 8 8 2 2 8 5 9 9 9 4 1 5 9 9 5 8 8 8 8 8 8 8 8 8 8 8 8 8 8 2 8 8 8 8 8 8 8 8 8 8 8 8 8 3 8 8 8 8 8 8 8 8 1 8 8 8 8 8 8 8 8 8 8 8 8 8 8 7 7 6 6 6 6 6 6 6 6 6 7 7 8 8 8 8 8 8 8 2 2 4
4 8 8 8 8 8 8 8 8 8 8 8 2 2 2 5 4 5 4 4 1 4 5 5 5 8 8 8 8 8 8 8 8 8 8 8 8 8 8 3 8 8 8 8 8 8 8 8 8 8 8 8 8 8 8 8 8 8 8 8 8 8 0 8 8 8 8 8 8 8 8 8 8 8 8 8 8 8 7 6 6 6 6 6 6 6 6 6 7 8 8 8 8 8 8 8 8 2 2 4
4 8 8 8 8 8 8 8 8 8 8 8 8 2 3 0 1 1 0 1 1 0 1 1 0 0 1 1 0 0 1 0 0 1 1 1 0 0 0 0 1 1 8 0 0 1 1 1 0 1 0 0 1 0 1 1 0 1 0 0 1 0 0 1 0 1 1 0 0 1 1 0 1 0 0 0 0 1 7 6 6 6 6 6 6 6 6 6 7 8 8 8 8 8 8 8 8 2 2 4
4 8 8 8 8 8 8 8 8 8 8 8 8 3 2 0 5 9 9 9 1 1 9 9 4 8 8 1 8 0 1 8 8 8 8 8 8 8 8 8 8 8 8 8 8 8 8 8 1 8 8 8 8 8 8 8 8 8 8 8 1 8 0 8 8 8 8 8 8 8 8 8 8 8 8 0 8 1 7 7 6 6 6 6 6 6 6 7 7 8 8 8 8 8 8 8 8 2 2 4
4 8 8 8 8 8 8 8 8 8 8 8 8 8 8 1 4 9 9 9 0 5 5 4 4 8 8 1 8 0 0 8 8 8 8 8 8 8 8 8 8 8 8 8 8 8 8 8 1 8 8 8 8 8 8 8 8 8 8 8 0 8 1 8 8 8 8 8 8 8 8 8 8 8 8 0 1 1 8 7 7 7 7 7 7 7 7 7 8 8 8 8 8 8 8 8 8 2 2 4
4 8 8 8 8 8 8 8 8 8 8 8 8 8 8 0 5 5 4 4 1 8 8 8 8 8 8 1 8 1 0 8 8 8 8 8 8 8 8 8 8 8 8 8 8 8 8 8 0 8 8 8 8 8 8 8 8 3 3 8 1 8 0 8 8 8 8 8 8 8 8 8 8 8 8 1 9 1 8 8 8 8 0 0 7 8 8 8 8 8 8 8 8 8 8 8 8 2 8 4
4 8 8 8 8 8 8 8 8 8 8 8 8 8 8 0 8 8 8 8 1 8 8 8 8 8 8 0 8 1 1 8 8 8 8 8 8 8 8 8 8 8 8 8 8 8 8 8 1 8 8 8 8 8 8 8 8 2 2 8 1 8 1 8 8 8 8 8 8 8 8 4 5 5 5 1 9 0 8 8 8 8 0 1 8 8 8 8 8 8 8 8 8 8 8 8 8 2 8 4
4 8 8 8 8 8 8 8 8 8 8 8 8 8 8 0 1 1 0 0 1 1 0 1 0 1 1 0 0 0 0 0 0 1 8 0 0 0 0 0 1 0 0 1 1 1 1 1 0 1 0 0 0 0 1 1 0 1 1 0 0 1 0 1 0 1 1 0 0 1 0 0 1 0 1 1 1 1 1 0 0 0 1 1 8 8 8 8 8 8 8 8 8 8 8 8 8 2 8 4
4 8 8 8 8 8 8 8 8 8 8 8 8 8 8 0 8 8 8 8 8 8 8 8 8 8 8 0 8 1 0 8 8 8 8 8 8 8 8 8 8 8 8 8 8 8 8 8 1 8 8 8 8 8 8 8 8 2 2 8 0 8 0 8 8 8 8 8 8 8 8 4 9 9 5 1 5 1 8 8 8 8 1 1 8 8 8 8 8 8 8 8 8 8 8 8 8 2 8 4
4 8 8 8 8 8 8 8 8 8 8 8 8 8 8 0 8 8 8 8 8 8 8 8 8 8 8 0 8 1 0 8 8 8 8 8 8 8 8 8 8 8 8 8 8 8 8 8 1 8 8 8 8 8 8 8 8 3 2 8 0 8 1 8 8 8 8 8 8 8 8 4 9 9 4 0 1 1 0 0 1 8 1 1 8 8 8 8 8 8 8 8 8 8 8 8 8 2 8 4
4 8 8 8 8 8 8 8 8 8 8 8 8 8 8 0 8 8 8 8 8 8 8 8 8 8 8 8 8 0 1 8 8 8 8 8 8 8 8 8 8 8 8 8 8 8 8 8 0 8 8 8 8 8 8 8 8 2 2 8 0 8 1 8 8 8 8 8 8 8 8 5 4 4 4 4 5 1 8 8 8 8 1 1 8 8 8 8 8 8 8 8 8 8 8 8 8 2 8 4
4 8 8 8 8 8 8 8 8 8 8 8 8 8 8 1 8 8 8 8 8 8 8 8 8 8 8 1 8 1 0 8 8 8 8 8 8 8 8 8 8 8 8 8 8 8 8 8 0 8 8 8 8 8 8 8 2 3 2 3 0 3 0 3 2 8 8 8 8 8 8 8 8 8 8 8 8 1 8 8 8 8 1 0 8 8 8 8 8 8 8 8 8 8 8 8 8 2 8 4
4 8 8 8 8 8 8 8 8 8 8 8 8 8 8 0 8 8 8 8 8 8 8 8 8 8 8 1 8 0 0 8 8 8 8 8 8 8 8 8 8 8 8 8 8 8 8 8 1 8 8 8 8 8 8 8 2 3 3 3 0 2 1 3 2 8 8 8 8 8 8 8 8 8 8 8 8 1 8 8 8 8 1 1 8 8 8 8 8 8 8 8 8 8 8 8 8 2 8 4
4 8 8 8 8 8 8 8 8 8 8 8 8 8 8 1 8 8 8 8 8 8 2 3 8 8 8 0 8 0 0 8 8 8 8 8 8 8 8 8 8 8 8 8 8 8 8 8 0 8 8 8 8 8 8 8 3 3 3 2 0 3 1 3 2 8 8 8 8 8 8 8 8 8 8 8 8 1 8 8 8 8 0 1 8 8 8 8 8 8 8 8 8 8 8 8 8 2 8 4
4 8 8 8 8 8 8 8 8 8 8 8 8 8 8 0 8 8 8 8 8 8 2 2 8 8 8 0 8 1 1 8 8 8 8 8 8 8 8 8 8 8 8 8 8 8 8 8 0 8 8 8 8 8 8 8 3 8 8 8 0 8 0 8 8 8 8 8 8 8 8 8 8 8 8 8 8 0 8 8 8 8 1 0 8 8 8 8 8 8 8 8 8 8 8 8 8 2 2 4
4 8 8 8 8 8 8 8 8 8 8 8 8 8 8 0 8 8 8 8 8 8 2 2 8 8 8 0 8 0 0 8 8 8 8 8 8 8 8 8 8 8 8 8 8 8 8 8 1 8 8 8 8 8 8 8 2 8 8 8 0 8 1 8 8 8 8 8 8 8 8 8 8 8 8 8 8 1 8 8 8 8 0 0 8 8 8 8 8 8 8 8 8 8 8 8 8 8 3 4
4 8 8 8 8 8 8 8 8 8 8 8 8 8 8 0 8 8 8 8 8 8 2 2 8 8 8 1 8 1 1 8 8 8 8 8 8 8 8 8 8 8 8 8 8 8 8 8 0 8 8 8 8 8 8 8 3 8 8 8 1 8 0 8 8 8 8 8 8 8 8 8 8 8 8 8 8 1 8 8 8 8 0 1 8 8 8 8 8 8 8 8 8 8 8 8 8 8 3 4
4 8 8 8 8 8 8 8 8 8 8 8 8 8 8 1 2 2 2 2 2 2 3 2 8 8 8 0 8 1 0 8 8 8 8 8 8 8 8 8 8 8 8 8 8 8 8 8 1 8 8 8 8 8 8 8 3 8 8 8 1 8 0 8 8 8 8 8 8 8 8 8 8 8 8 8 8 0 8 8 8 8 0 0 8 8 8 8 8 8 8 8 8 8 8 8 8 8 2 4
4 8 8 8 8 8 8 8 8 8 8 8 8 8 8 1 8 8 8 8 8 8 8 2 3 8 8 1 3 0 0 8 8 8 8 8 8 8 8 8 8 8 8 8 8 8 8 8 0 8 8 8 8 8 8 8 3 8 8 8 0 8 1 8 8 8 8 8 8 8 8 8 8 8 8 8 8 1 8 8 8 8 0 0 8 8 8 8 8 8 8 8 8 8 8 8 8 8 3 4
4 8 8 8 8 8 8 8 8 8 8 8 8 8 8 8 8 8 8 8 8 8 8 8 3 8 8 0 8 1 1 8 8 8 8 8 8 8 8 8 8 8 8 8 8 8 8 8 0 8 8 8 8 8 8 8 2 8 8 8 1 8 0 8 8 8 8 8 8 8 8 8 8 8 8 8 8 0 8 8 8 8 0 0 8 8 8 8 8 8 8 8 8 8 8 8 8 8 8 4
4 8 8 8 8 8 8 8 8 8 8 8 8 8 8 1 8 8 8 8 3 2 2 8 3 2 8 1 8 1 1 8 8 8 8 8 8 8 8 8 8 8 8 8 8 8 8 8 1 8 8 8 8 8 8 8 2 8 8 8 1 8 1 8 8 8 8 8 8 8 8 8 8 8 8 8 8 1 8 8 8 8 0 1 8 8 8 8 8 8 8 8 8 8 8 8 8 8 8 4
4 3 2 2 2 8 8 8 8 8 8 8 8 8 8 1 1 3 8 8 3 8 2 8 8 3 8 0 8 1 1 8 8 8 8 8 8 8 8 8 8 8 8 8 8 8 8 8 0 8 8 8 8 8 8 8 2 8 8 8 1 8 1 8 8 8 8 8 8 8 8 8 8 8 8 8 8 0 8 8 8 8 1 1 8 8 8 8 8 8 8 8 8 8 8 8 8 8 8 4
4 2 2 3 2 3 2 3 3 2 8 8 8 8 8 1 8 3 8 8 2 8 2 3 3 2 8 1 8 1 0 8 8 8 8 8 8 8 8 8 8 8 8 8 8 8 8 8 0 3 2 3 2 2 2 2 3 8 8 8 0 8 1 8 8 8 8 8 8 8 8 8 8 8 8 8 8 1 8 8 8 8 0 0 8 8 8 8 8 8 8 8 8 8 8 8 8 8 8 4
4 2 3 3 2 2 3 3 2 3 8 8 8 8 8 0 8 3 3 8 3 3 8 8 8 8 8 0 8 1 1 8 8 8 8 8 8 8 8 8 8 8 8 8 8 8 8 8 0 8 8 8 8 3 2 2 3 3 2 2 1 8 0 8 8 8 8 8 8 8 8 8 8 8 8 8 8 1 8 8 8 8 1 1 8 8 8 8 8 8 8 8 8 8 8 8 8 8 8 4
4 2 2 3 3 3 2 3 2 2 8 8 8 8 8 0 8 8 3 8 8 3 8 8 8 8 8 1 8 0 0 8 8 8 8 8 8 8 8 8 8 8 8 8 8 8 8 8 0 8 8 8 8 8 8 8 8 8 8 8 1 8 1 8 8 8 8 8 8 8 8 8 8 8 8 8 8 1 8 8 8 8 0 0 8 8 8 8 8 8 8 8 8 8 8 8 8 8 8 4
4 3 2 3 3 3 3 3 2 3 0 0 0 0 1 1 8 8 2 2 2 2 8 8 8 8 8 0 8 1 1 8 8 8 8 8 8 8 8 8 8 8 8 8 8 8 8 8 1 8 8 8 8 8 8 8 8 8 8 8 0 8 1 8 8 8 8 8 8 8 8 8 8 8 8 8 8 0 8 8 8 8 0 0 8 8 8 8 8 8 8 8 8 8 8 8 8 8 8 4
4 2 3 2 3 2 2 3 3 3 8 8 8 8 8 1 8 8 8 8 8 8 8 8 8 8 8 0 8 0 1 8 8 8 8 8 8 8 8 8 8 8 8 8 8 8 8 8 0 8 8 8 8 8 8 8 8 8 8 8 0 8 1 8 8 8 8 8 8 8 8 8 8 8 8 8 8 1 8 8 8 8 1 1 8 8 8 8 8 8 8 8 8 8 8 8 8 8 8 4
4 3 3 3 2 3 3 8 8 8 8 8 8 8 8 0 8 8 8 8 8 8 8 8 8 8 8 1 8 0 1 3 2 2 8 8 8 8 8 8 8 8 8 2 8 8 8 7 7 7 8 8 8 8 8 8 8 8 8 8 0 8 0 8 8 8 8 8 8 8 8 8 8 8 8 8 8 0 8 8 8 8 0 1 8 8 8 8 8 8 8 8 8 8 8 8 8 8 8 4
4 8 8 8 8 3 2 8 8 8 8 8 8 8 8 1 8 8 8 8 8 8 8 8 8 8 8 0 8 1 1 2 3 3 8 8 8 8 8 8 8 8 8 3 7 7 7 7 7 7 7 7 7 8 8 8 8 8 8 8 0 8 1 8 8 8 8 8 8 8 8 8 8 8 8 8 8 0 8 8 8 8 1 1 8 8 8 8 8 8 8 8 8 8 8 8 8 8 8 4
4 8 8 8 8 3 2 8 8 8 8 8 8 8 8 0 8 8 8 8 8 8 8 8 8 8 8 1 8 0 1 8 8 8 8 8 8 8 8 8 8 8 8 7 7 6 6 6 6 6 6 6 7 7 8 8 8 8 8 8 1 8 1 8 8 8 8 8 8 8 8 8 8 8 8 8 8 0 8 8 8 8 1 1 8 8 8 8 8 8 8 8 8 8 8 8 8 8 8 4
4 8 8 8 8 2 3 8 8 8 8 8 8 8 8 0 8 8 8 8 8 8 8 8 8 8 8 1 8 1 0 8 8 8 8 8 8 8 8 8 8 2 2 7 6 6 6 6 6 6 6 6 6 7 8 8 8 8 8 8 0 8 1 8 8 8 8 8 8 8 8 8 8 8 8 8 8 0 8 8 8 8 0 0 8 8 8 8 8 8 8 8 8 8 8 8 8 8 8 4
4 8 8 8 8 3 2 8 8 8 8 8 8 8 8 1 8 8 8 8 8 8 8 8 8 8 8 0 8 0 0 8 8 8 8 8 8 8 8 8 8 8 8 7 6 6 6 6 6 6 6 6 6 7 8 8 8 8 8 8 0 8 1 8 8 8 8 8 8 8 8 8 8 8 8 8 8 1 8 8 8 8 0 0 8 8 8 8 8 8 8 8 8 8 8 8 8 8 8 4
4 8 8 8 8 8 8 8 8 8 8 8 8 8 8 1 8 8 8 8 8 8 8 8 8 8 8 1 8 1 0 8 8 8 8 8 8 8 8 8 8 8 7 7 6 6 6 6 6 6 6 6 6 7 7 8 8 8 8 8 0 8 0 8 8 8 8 8 8 8 8 8 8 8 8 8 8 1 8 8 8 8 1 0 8 8 8 8 8 8 8 8 8 8 8 8 8 8 8 4
4 8 8 8 8 8 8 8 8 8 8 8 8 8 8 0 8 8 8 8 8 8 8 8 8 8 8 0 8 1 0 8 8 8 8 8 8 8 8 8 8 8 7 6 6 6 6 6 6 6 6 6 6 6 7 8 8 8 8 8 1 8 1 8 8 8 8 8 8 8 8 8 8 8 8 8 8 0 8 8 8 8 0 0 8 8 8 8 8 8 8 8 8 8 8 8 8 8 8 4
4 8 8 8 8 8 8 8 8 8 8 8 8 8 8 1 8 8 8 8 8 8 8 8 8 8 8 1 8 0 1 8 8 8 8 8 8 8 8 8 8 8 7 7 6 6 6 6 6 6 6 6 6 7 7 8 8 8 8 8 1 8 1 8 8 8 8 8 8 8 8 8 8 8 8 8 8 0 8 8 8 8 1 0 8 8 8 8 8 8 8 8 8 8 8 8 8 8 8 4
4 8 8 8 8 8 8 8 8 8 8 8 8 8 8 0 8 8 8 8 8 8 8 8 8 8 8 0 8 0 1 8 8 8 8 8 8 8 8 8 8 8 8 7 6 6 6 6 6 6 6 6 6 7 8 8 8 8 8 8 1 8 1 8 8 8 8 8 8 8 8 8 8 8 8 8 8 1 8 8 8 8 1 1 8 8 8 8 8 8 8 8 8 8 8 8 8 8 8 4
4 8 8 8 8 8 8 8 8 2 2 3 3 3 8 0 8 8 8 8 8 8 8 8 8 8 8 0 8 0 1 8 8 8 8 8 8 8 3 8 8 8 8 7 6 6 6 6 6 6 6 6 6 7 8 8 8 8 8 8 0 8 0 8 8 8 8 8 8 8 8 8 8 8 8 8 8 0 8 8 8 8 0 1 8 8 8 8 8 8 8 8 8 8 8 8 8 8 8 4
4 8 8 8 8 8 8 8 8 2 3 2 3 3 2 0 8 8 8 8 8 8 8 8 8 8 8 0 8 1 0 8 8 8 8 8 8 8 2 8 8 8 8 7 7 6 6 6 6 6 6 6 7 7 8 8 8 8 8 8 1 8 0 8 8 8 8 8 8 8 8 8 8 8 8 8 8 0 8 8 8 8 1 1 8 8 8 8 8 8 8 8 8 8 8 8 8 8 8 4
4 8 8 8 8 8 8 8 8 2 3 3 3 2 8 1 8 8 8 8 8 8 8 8 8 8 8 8 8 1 0 8 8 8 8 8 8 8 2 2 3 2 2 3 7 7 7 7 7 7 7 7 7 8 8 8 8 8 8 8 1 8 1 8 8 8 8 8 8 8 8 8 8 8 8 8 8 1 8 8 8 8 1 0 8 8 8 8 8 8 8 8 8 8 8 8 8 8 8 4
4 8 8 8 8 8 8 8 8 2 3 8 8 8 8 0 8 8 8 8 8 8 8 8 8 8 7 7 7 7 1 8 8 8 8 8 8 8 8 8 8 8 8 8 8 8 8 7 7 7 8 8 8 8 8 8 8 5 4 5 0 5 0 5 8 8 8 8 8 8 8 8 8 8 8 8 8 1 2 3 8 8 0 0 8 8 8 8 8 8 8 8 8 8 8 8 8 8 8 4
4 8 8 8 8 8 8 8 8 2 2 8 8 8 8 1 8 8 8 8 8 8 8 7 7 7 7 7 7 7 7 7 8 8 8 8 8 8 8 8 8 8 8 8 8 8 8 8 1 8 8 8 8 8 8 8 8 4 8 8 1 8 1 5 8 8 8 8 8 8 8 8 8 8 8 8 8 1 3 3 8 8 1 1 8 8 8 8 8 8 8 8 8 8 8 8 8 8 8 4
4 2 3 2 2 3 8 8 8 8 8 8 8 8 8 1 8 8 8 8 8 8 7 7 6 6 6 6 6 6 6 7 7 8 8 8 8 8 8 8 8 8 8 8 8 8 8 8 0 8 8 8 8 8 8 8 8 5 8 8 0 8 1 4 8 8 8 8 8 8 8 8 8 8 8 8 8 0 3 2 8 8 0 0 8 8 8 8 8 8 8 8 8 8 8 8 8 8 8 4
4 3 3 3 2 3 8 8 8 8 8 8 8 8 8 1 8 8 8 8 8 7 7 6 6 6 6 6 6 6 6 6 7 7 8 8 8 8 8 8 8 8 8 8 8 8 8 8 0 8 8 8 8 8 8 8 8 5 8 8 1 8 1 5 8 8 8 8 8 8 8 8 2 2 2 3 2 1 3 3 8 8 0 0 8 8 8 8 8 8 8 8 8 8 8 8 8 8 8 4
4 2 2 2 3 3 8 8 8 8 8 8 8 8 8 1 8 8 8 8 8 7 6 6 6 6 6 6 6 6 6 6 6 7 8 8 8 8 8 8 8 8 8 8 8 8 8 8 1 8 8 8 8 8 8 8 8 5 8 8 0 8 0 4 8 8 8 8 8 8 8 8 8 8 8 8 3 1 3 3 8 8 1 0 8 8 8 8 8 8 8 8 8 8 8 8 8 8 8 4
4 8 8 8 8 8 8 8 8 8 8 8 8 8 8 1 8 8 8 8 8 7 6 6 6 6 6 6 6 6 6 6 6 7 8 8 8 8 8 8 8 8 8 8 8 8 8 8 0 8 8 8 8 8 8 8 8 4 8 8 1 8 1 4 8 8 8 8 8 8 8 8 8 8 8 8 2 0 2 3 8 8 0 0 8 8 8 8 8 8 8 8 8 8 8 8 8 8 8 4
4 8 8 8 8 8 8 8 8 8 8 8 8 8 8 0 8 8 8 8 7 7 6 6 6 6 6 6 6 6 6 6 6 7 7 8 8 8 8 8 8 8 8 8 8 8 8 8 0 8 8 2 3 3 8 8 8 5 5 5 1 5 1 5 8 8 8 8 8 8 8 8 8 8 8 8 2 1 8 8 8 8 0 0 8 8 8 8 8 8 8 8 8 8 8 8 8 8 8 4
4 8 8 8 8 8 8 8 8 8 8 8 8 8 8 0 8 8 8 8 7 6 6 6 6 6 6 6 6 6 6 6 6 6 7 8 8 8 8 8 8 8 8 8 8 8 8 8 1 8 8 8 8 8 8 8 8 8 8 8 0 8 0 8 8 8 8 8 8 8 8 8 8 8 8 8 3 0 8 8 8 8 1 1 8 8 8 8 8 8 8 8 8 8 8 8 8 8 8 4
4 8 8 8 8 8 8 8 8 8 8 8 8 8 7 7 7 8 8 8 7 7 6 6 6 6 6 6 6 6 6 6 6 7 7 8 8 8 8 8 8 8 8 8 8 8 8 8 0 8 8 8 8 8 8 8 8 8 8 8 1 8 0 8 8 8 8 8 8 8 8 8 8 8 8 8 2 0 8 8 8 8 0 0 8 8 8 8 8 8 8 8 8 8 8 8 8 8 8 4
4 8 8 8 8 8 8 8 8 8 8 7 7 7 7 7 7 7 7 7 8 7 6 6 6 6 6 6 6 6 6 6 6 7 8 8 8 8 8 8 8 8 8 8 8 8 8 8 0 8 8 8 8 8 8 8 8 8 8 8 1 8 1 8 8 8 8 8 8 8 8 8 8 8 8 8 7 1 7 8 8 8 1 0 8 8 8 8 8 8 8 8 8 8 8 8 8 8 8 4
4 8 8 8 8 8 8 8 8 8 7 7 6 6 6 6 6 6 6 7 7 7 6 6 6 6 6 6 6 6 6 6 6 7 8 8 8 8 8 8 8 8 8 8 8 8 8 8 0 8 8 8 8 8 8 8 8 8 8 8 0 8 0 8 8 8 8 8 8 8 8 8 8 7 7 7 7 7 7 7 7 7 0 0 8 8 8 8 8 8 8 8 8 8 8 8 8 8 8 4
4 8 8 8 8 8 8 8 8 7 7 6 6 6 6 6 6 6 6 6 7 7 7 6 6 6 6 6 6 6 6 6 7 7 8 8 8 8 8 8 8 8 8 8 8 8 8 8 1 8 8 8 8 8 8 8 8 8 8 8 0 8 1 8 8 8 8 8 8 8 8 8 7 7 6 6 7 7 7 6 6 7 1 1 8 8 8 8 8 8 8 8 8 8 8 8 8 8 8 4
4 8 8 8 8 8 8 8 8 7 6 6 6 6 6 6 6 6 6 6 6 7 7 7 6 6 6 6 6 6 6 7 7 8 8 8 8 8 8 8 8 8 8 8 8 8 8 8 0 8 8 8 8 8 8 8 8 8 8 8 0 8 0 8 8 8 8 8 8 8 8 8 7 6 6 6 7 7 6 6 6 7 0 1 8 8 8 8 8 8 8 8 8 8 8 8 8 8 8 4
4 8 8 8 8 8 8 8 8 7 6 6 6 6 6 6 6 6 6 6 6 7 8 7 7 7 7 7 7 1 7 7 8 8 8 8 8 8 8 8 8 8 2 2 2 2 8 8 0 8 8 8 8 8 8 8 8 8 8 8 0 8 0 8 8 8 8 8 8 8 8 8 7 6 6 6 7 7 6 6 6 7 7 0 8 8 8 8 8 8 8 8 8 8 8 8 8 8 8 4
4 8 8 8 8 8 8 8 7 7 6 6 6 6 6 6 6 6 6 6 6 7 7 8 8 8 7 0 7 0 0 5 4 5 8 8 8 8 8 8 8 8 8 8 8 8 8 8 1 8 8 8 8 8 8 8 8 8 8 8 1 8 0 8 8 8 8 8 8 8 8 7 7 6 6 6 7 7 6 6 6 7 7 1 8 8 8 8 8 8 8 8 8 8 8 8 8 8 8 4
4 8 8 8 8 8 8 8 7 6 6 6 6 6 6 6 6 6 6 6 6 6 7 8 8 8 8 1 8 0 0 9 9 4 5 8 8 8 8 8 8 8 8 8 8 8 8 2 1 8 8 8 8 8 8 8 8 8 8 8 0 8 0 8 8 8 3 2 2 2 8 7 6 6 6 6 7 7 7 6 6 7 7 0 8 8 8 8 8 8 8 8 8 8 8 8 8 8 8 4
4 8 8 8 8 8 8 8 7 7 6 6 6 6 6 6 6 6 6 6 6 7 7 8 8 8 8 1 8 1 1 5 4 5 5 8 8 8 8 8 8 8 8 8 8 8 8 2 0 8 8 8 8 8 8 8 8 8 8 8 0 8 0 8 8 8 8 8 8 8 8 7 7 6 6 6 7 7 7 7 6 7 7 1 8 8 8 8 8 8 8 8 8 8 8 8 8 8 8 4
4 8 8 8 8 8 8 8 8 7 6 6 6 6 6 6 6 6 6 6 6 7 8 8 8 8 8 1 8 1 0 0 1 9 5 8 8 8 8 8 8 8 8 8 8 8 8 3 0 8 8 8 8 8 8 8 8 8 8 8 1 8 1 8 8 8 8 8 8 8 8 8 7 7 7 7 7 7 7 7 7 7 7 1 8 8 8 8 8 8 8 8 8 8 8 8 8 8 8 4
4 8 8 8 8 8 8 8 8 7 6 6 6 6 6 6 6 6 6 6 6 7 0 1 1 1 0 1 0 1 0 0 0 0 1 1 1 1 1 1 0 1 1 1 1 1 0 0 1 1 1 1 0 0 1 0 0 1 1 0 0 1 1 0 1 1 0 1 0 1 0 1 7 7 7 6 6 6 6 7 7 7 7 7 8 8 8 8 8 8 8 8 8 8 8 8 8 8 8 4
4 8 8 8 8 8 8 8 8 7 7 6 6 6 6 6 6 6 6 6 7 7 8 8 8 8 3 3 3 1 1 5 4 5 2 2 1 8 8 8 8 8 8 8 8 8 8 2 3 8 8 8 8 8 8 8 8 8 8 8 8 8 8 8 8 8 8 8 8 8 8 8 7 7 6 6 6 6 6 6 6 7 9 7 7 7 8 8 8 8 8 8 8 8 8 8 8 8 8 4
4 8 8 8 8 8 8 8 8 8 7 7 6 6 6 6 6 6 6 7 7 8 8 8 8 8 8 8 8 1 0 9 9 4 2 3 0 8 8 8 8 8 8 8 8 8 8 8 8 8 8 8 8 8 8 8 8 8 8 8 8 8 8 8 8 8 8 8 8 8 8 8 8 7 7 7 7 6 7 7 6 6 9 6 6 7 8 8 8 8 8 8 8 8 8 8 8 8 8 4
4 8 8 8 8 8 8 8 8 8 8 7 7 7 7 6 7 7 7 7 8 8 8 8 8 8 8 8 8 0 1 9 9 4 8 8 1 8 8 8 8 8 8 8 8 8 8 8 8 8 8 8 8 8 8 8 8 8 8 8 8 8 8 8 8 8 8 8 8 8 8 8 8 8 8 8 7 7 7 7 6 6 9 6 6 7 7 8 8 8 8 8 8 8 8 8 8 8 8 4
4 8 8 8 8 8 8 8 8 8 8 8 4 8 7 7 7 8 4 8 8 8 8 8 8 8 8 8 8 0 0 5 5 5 8 8 0 8 8 8 8 8 8 8 8 8 8 8 8 8 8 8 8 8 8 8 8 8 8 8 8 8 8 8 8 8 8 8 8 8 8 8 8 8 8 8 8 8 7 6 6 6 9 6 6 6 7 2 8 8 8 8 8 8 8 8 8 2 3 4
4 8 8 8 8 8 8 8 8 8 8 8 4 4 4 0 4 4 4 8 8 8 8 8 8 8 8 8 8 1 1 1 8 8 8 8 0 8 8 8 8 8 8 8 8 8 8 8 8 8 8 8 8 8 8 8 8 8 8 8 8 8 8 8 8 8 8 8 8 8 8 8 8 8 8 8 8 8 7 7 6 6 6 6 6 7 7 8 8 8 8 8 8 8 8 8 8 2 3 4
4 8 8 8 8 8 8 8 8 8 8 8 4 9 9 9 9 9 4 8 8 8 8 8 8 8 8 8 8 0 8 8 8 8 8 8 0 8 8 8 8 8 8 8 8 8 8 8 8 8 8 8 8 8 8 8 8 8 8 8 8 8 8 8 8 8 8 8 8 8 8 8 8 8 8 8 8 8 8 7 6 6 6 6 6 7 8 8 8 8 8 8 8 8 8 8 8 8 8 4
4 8 8 8 8 8 8 8 8 8 8 8 4 9 9 9 9 9 5 8 8 8 8 8 8 8 8 8 8 1 8 8 8 8 8 8 0 8 8 8 8 8 8 8 8 8 8 8 8 8 8 8 8 8 8 8 8 8 8 8 8 8 8 8 8 8 8 8 8 8 8 8 8 8 8 8 8 8 8 7 7 7 6 7 7 7 8 8 8 8 8 8 8 8 8 8 8 8 8 4
4 8 8 8 8 8 8 8 8 8 8 8 4 4 5 9 5 4 5 8 8 8 8 8 8 8 8 8 7 9 7 8 8 8 8 8 0 8 8 8 8 8 8 8 8 8 8 8 8 8 8 8 8 8 8 8 8 8 8 8 8 8 8 8 8 8 8 8 8 8 8 8 8 8 8 8 8 8 8 8 8 7 7 7 8 8 8 8 8 8 8 8 8 8 8 8 8 8 8 4
4 2 2 2 2 2 2 2 2 8 8 8 8 8 8 9 8 8 8 8 8 8 8 8 8 8 7 7 7 9 7 7 7 8 8 8 1 8 8 8 8 8 8 8 8 8 8 8 8 8 8 8 8 8 8 8 8 8 8 8 8 8 8 8 8 8 8 8 8 8 8 8 8 8 8 8 8 8 8 8 8 8 8 8 8 8 8 8 8 8 8 8 3 8 8 8 8 8 8 4
4 2 2 2 2 8 2 2 2 8 8 8 8 8 8 9 8 8 8 8 8 8 8 8 8 8 7 6 6 9 6 6 7 8 8 8 0 8 8 8 8 8 8 8 8 8 8 8 8 8 8 8 8 8 8 8 8 8 8 8 8 8 8 8 8 8 8 8 8 8 8 8 8 8 8 8 8 8 8 8 8 8 8 8 8 8 8 8 8 8 8 8 2 8 8 8 8 8 8 4
4 2 2 2 2 2 2 2 2 8 8 8 8 8 8 9 8 8 8 8 8 8 8 8 8 7 7 6 6 9 6 6 7 7 8 8 1 8 8 8 8 8 8 8 8 8 8 8 8 8 8 8 8 8 8 8 8 8 8 8 8 8 8 8 8 8 8 8 8 8 8 8 8 8 8 8 8 8 8 8 8 8 8 8 8 8 8 8 8 8 8 8 8 8 8 8 8 8 8 4
4 2 2 2 2 2 2 2 2 8 8 8 8 8 8 9 8 8 8 8 8 8 8 8 8 7 6 6 6 9 6 6 6 7 8 8 1 8 8 8 8 8 8 8 8 8 8 8 8 8 8 8 8 8 8 8 8 8 8 8 8 8 8 8 8 8 8 8 8 8 8 8 8 8 8 8 8 8 8 8 8 8 8 8 8 8 8 8 8 8 8 8 8 8 8 8 8 8 8 4
4 2 2 8 2 2 2 2 2 2 2 9 9 9 9 9 8 8 8 8 8 8 8 8 8 7 7 6 6 6 6 6 7 7 8 8 1 8 8 8 8 8 8 8 8 8 8 8 8 8 8 8 8 8 8 8 8 8 8 8 8 8 8 8 8 8 8 8 8 8 8 8 8 8 8 8 8 8 8 8 8 8 8 8 8 8 8 8 8 8 8 8 8 8 8 8 8 8 8 4
4 2 2 2 2 2 2 2 2 8 8 8 8 8 8 8 8 8 8 8 8 8 8 8 8 8 7 6 6 6 6 6 7 8 8 8 0 8 8 8 8 8 8 8 8 8 8 8 8 8 8 8 8 8 8 8 8 8 8 8 8 8 8 8 8 8 8 8 8 8 8 8 8 8 8 8 8 8 8 8 8 8 8 8 8 8 8 8 8 8 8 8 8 8 8 8 8 8 8 4
4 2 2 2 2 2 8 2 2 8 8 8 8 8 8 8 8 8 8 8 8 8 8 8 8 8 7 7 7 6 7 7 7 8 8 8 0 8 8 8 8 8 8 8 8 8 8 8 8 8 8 8 8 8 8 8 8 8 8 8 8 8 8 8 8 8 8 8 8 8 8 8 8 8 8 8 8 8 8 8 8 8 8 8 8 8 8 8 8 8 8 8 8 8 8 8 8 8 8 4
4 2 2 2 2 2 2 2 2 8 8 8 8 8 8 8 8 8 8 8 8 8 8 8 8 8 8 8 7 7 7 8 8 8 8 8 0 8 8 8 8 8 8 8 8 8 8 8 8 8 8 8 8 8 8 8 8 8 8 8 8 8 8 8 8 8 8 8 8 8 8 8 8 8 8 8 8 8 8 8 8 8 8 8 8 8 8 8 8 8 8 8 8 8 8 8 8 8 8 4
4 8 8 8 8 8 8 8 8 8 8 8 8 8 8 8 8 8 8 8 8 8 8 8 8 8 8 8 8 7 8 8 8 8 8 8 1 8 8 8 8 8 8 8 8 8 8 8 8 8 8 8 8 8 8 8 8 8 8 3 3 3 3 3 3 3 3 3 3 3 3 3 3 3 8 8 8 8 8 8 8 8 8 8 8 8 8 8 8 8 8 8 8 8 8 8 8 8 8 4
4 8 8 8 8 8 8 8 8 8 8 8 8 8 8 8 8 8 8 8 8 8 8 8 8 8 8 8 8 7 8 8 8 8 8 8 0 8 8 8 8 8 8 8 8 8 8 8 8 8 8 8 8 8 8 8 8 8 8 3 3 8 3 3 3 3 3 8 3 3 3 3 3 3 8 8 8 8 8 8 8 8 8 8 8 8 8 8 8 8 8 8 8 8 8 8 8 8 8 4
4 8 8 8 8 8 8 8 8 8 8 8 8 8 8 8 8 8 8 8 8 8 8 8 8 8 8 8 8 7 8 8 8 8 8 8 0 8 8 8 8 8 8 8 8 8 8 8 8 8 8 8 8 8 8 8 8 8 8 3 3 3 3 3 3 3 3 3 9 9 9 3 3 3 8 8 8 8 8 8 8 8 8 8 8 8 8 8 8 8 8 8 8 8 8 8 8 8 8 4
4 8 8 8 8 8 8 8 8 8 8 8 8 8 8 8 8 8 8 8 8 8 8 8 8 8 8 2 3 7 8 8 8 8 8 8 1 8 8 8 8 8 8 8 8 8 8 8 8 8 8 8 8 8 8 8 8 8 8 3 3 3 3 3 3 3 3 3 3 3 9 3 3 3 8 8 8 8 8 8 8 8 8 8 8 8 8 8 8 8 8 8 8 8 8 8 8 8 8 4
4 8 8 8 8 8 8 8 8 8 8 8 8 8 8 8 8 8 8 8 8 8 8 8 8 8 8 2 3 7 8 8 8 8 8 8 0 8 8 8 8 8 8 8 8 8 8 8 8 8 8 8 8 8 8 8 8 8 8 3 3 3 8 3 3 3 3 3 3 3 9 3 3 3 8 8 8 8 8 8 8 8 8 8 8 8 8 8 8 8 8 8 8 8 8 8 8 8 8 4
4 8 8 8 8 8 8 8 8 8 8 8 8 8 8 8 8 8 8 8 8 8 7 7 7 7 7 7 7 7 7 7 7 7 7 7 0 7 7 7 7 7 7 7 7 7 7 7 7 7 7 0 0 0 0 0 0 8 8 3 3 3 3 3 3 3 3 3 9 9 9 8 3 3 8 8 8 8 8 8 8 8 8 8 8 8 8 8 8 8 8 8 8 8 8 8 8 8 8 4
4 8 8 8 8 8 8 8 8 8 8 8 8 8 8 8 8 8 8 8 8 8 6 6 6 6 6 6 6 6 6 6 6 6 6 6 6 6 6 6 6 6 6 6 6 6 6 6 6 6 6 8 8 8 8 8 0 0 0 3 3 3 3 3 3 3 3 3 8 3 3 3 3 3 8 8 8 8 8 8 8 8 8 8 8 8 8 8 8 8 8 8 8 8 8 8 8 8 8 4
4 4 4 4 4 4 4 4 4 4 4 4 4 4 4 4 4 4 4 4 4 4 4 4 4 4 4 4 4 4 4 4 4 4 4 4 4 4 4 4 4 4 4 4 4 4 4 4 4 4 4 4 4 4 4 4 4 4 4 4 4 4 4 4 4 4 4 4 4 4 4 4 4 4 4 4 4 4 4 4 4 4 4 4 4 4 4 4 4 4 4 4 4 4 4 4 4 4 4 4
