14 14 14 14 14 14 14 14 14 14 14 14 14 14 14 14 14 14 14 14 14 14 14 14 14 14 14 14 14 14 14 14 14 14 14 14 14 14 14 14 14 14 14 14 14 14 14 14 14 14 14 14 14 14 14 14 14 14 14 14 14 14 14 14 14 14 14 14 14 14 14 14 14 14 14 14 14 14 14 14 14 14 14 14 14 14 14 14 14 14 14 14 14 14 14 14 14 14 14 14
14 13 13 13 13 12 42 42 42 42 42 42 42 42 42 42 42 42 42 42 42 13 12 12 13 13 12 42 42 42 42 42 42 42 13 12 42 42 42 42 42 42 42 42 42 42 42 42 42 42 42 42 42 42 42 42 42 42 42 12 13 12 13 12 12 42 42 42 42 42 42 42 42 42 42 42 42 42 42 42 42 42 42 42 13 12 42 42 42 42 42 42 42 42 42 42 42 42 12 14
14 42 42 42 42 13 13 13 42 42 42 42 42 42 42 42 42 42 42 12 12 13 13 13 13 13 13 42 42 42 42 42 42 42 12 13 42 42 42 42 42 42 42 42 42 42 42 42 42 42 42 42 42 42 42 42 42 42 42 42 42 42 42 42 42 42 42 42 42 42 42 42 42 42 42 42 42 42 42 42 42 42 42 42 13 13 42 42 42 42 42 42 42 42 42 12 12 12 12 14
14 42 42 42 42 42 42 13 42 42 42 42 42 42 42 42 42 42 12 12 12 42 42 42 42 42 13 42 42 42 42 42 42 42 12 12 42 42 42 42 42 42 42 42 42 42 42 42 42 42 42 42 42 42 42 42 42 42 42 42 42 12 12 12 42 42 42 42 42 42 42 42 42 42 42 42 42 42 42 42 42 42 42 42 42 42 42 42 42 42 42 42 42 42 42 12 12 12 12 14
14 42 42 42 42 42 42 12 12 12 12 12 12 12 12 12 12 13 12 12 12 42 42 42 42 42 12 12 42 42 42 42 42 42 42 12 42 42 12 42 12 42 42 12 12 12 42 42 42 42 42 42 42 42 42 42 42 42 12 12 12 12 12 12 12 12 12 42 42 42 42 42 42 42 42 42 42 42 42 42 42 42 42 42 42 42 42 42 42 42 42 42 42 42 42 12 12 12 12 14
14 42 42 42 42 42 42 42 42 42 42 42 42 42 42 42 42 42 12 12 12 42 42 42 42 42 12 13 12 12 12 12 12 13 12 12 42 13 12 12 12 13 42 12 12 12 42 42 42 42 42 42 42 42 42 42 42 12 12 21 17 17 17 17 17 22 12 12 42 42 42 42 42 42 42 42 42 42 42 42 42 42 42 42 42 12 12 12 13 12 13 12 13 12 13 12 12 12 12 14
14 42 42 42 42 42 42 42 42 42 42 42 42 42 42 42 42 42 42 12 42 42 42 42 42 42 42 42 12 13 12 12 12 13 12 12 12 13 12 13 12 12 12 12 12 12 42 42 42 42 42 42 42 42 42 42 12 12 21 16 16 16 16 16 16 16 22 12 12 42 42 42 42 42 42 42 42 42 42 42 42 42 42 12 12 12 12 12 13 12 13 12 13 12 13 12 12 12 12 14
14 42 42 42 42 42 42 42 42 42 42 42 42 42 42 42 42 42 42 42 42 42 42 42 42 42 42 42 42 42 42 42 42 42 12 13 12 13 12 12 12 13 12 12 12 12 42 42 42 42 42 42 42 42 42 42 12 21 16 16 16 16 16 16 16 16 16 22 12 42 42 42 42 42 42 42 42 42 42 42 42 42 42 12 12 12 12 12 13 12 13 12 13 12 13 12 42 12 12 14
14 42 42 42 42 42 42 42 42 13 13 42 42 42 42 42 42 42 42 42 42 42 42 42 42 42 42 42 42 42 42 42 42 42 12 12 12 13 42 12 42 12 12 12 12 12 42 42 42 42 42 12 12 12 13 42 12 19 16 16 16 16 16 16 16 16 16 20 12 42 42 42 42 42 42 42 42 42 42 42 42 42 42 12 12 12 12 12 13 12 13 12 13 12 13 12 42 12 12 14
14 42 42 42 42 42 42 42 42 12 13 12 12 12 13 12 13 42 42 42 42 42 42 42 42 42 42 42 42 42 42 42 42 42 12 42 12 42 42 12 42 42 12 42 42 42 42 42 42 42 42 42 42 42 42 12 12 19 16 16 16 16 16 16 16 16 16 20 12 12 42 42 42 42 42 42 42 42 42 42 42 42 42 12 12 12 12 12 13 12 13 12 13 12 13 12 42 12 12 14
14 42 42 42 42 42 42 42 42 13 12 12 13 12 12 13 12 42 42 42 42 42 42 42 42 42 42 42 42 42 42 42 42 42 42 42 42 42 42 13 42 42 42 42 42 42 42 42 42 42 42 42 42 42 42 12 12 19 16 16 16 16 43 16 16 16 16 20 12 12 42 42 42 42 42 42 42 42 42 42 42 42 42 12 12 42 42 42 42 42 42 42 42 42 42 42 42 12 12 14
14 42 42 42 42 42 42 42 42 12 13 12 12 42 12 13 13 42 42 42 42 42 42 42 42 42 42 42 42 42 42 42 42 42 42 42 42 42 42 12 42 42 42 42 42 42 42 42 42 42 42 42 42 42 42 12 12 19 16 16 16 16 43 16 16 16 16 20 12 12 42 42 42 42 42 42 42 42 42 42 42 42 12 12 12 42 42 42 42 42 42 42 42 42 42 42 42 12 12 14
14 12 42 42 42 42 42 42 42 42 42 12 12 12 12 12 12 42 42 42 42 42 42 42 42 42 42 42 42 42 42 42 42 42 42 42 42 42 42 13 42 42 42 42 42 42 42 42 42 42 42 42 42 42 42 42 12 19 16 16 16 16 43 16 16 16 16 20 12 42 42 42 42 42 42 42 42 42 42 12 12 12 12 12 12 12 12 12 42 42 42 42 42 42 42 42 42 12 12 14
14 12 42 42 42 42 42 42 42 42 42 42 12 12 42 12 42 42 42 42 42 42 42 42 42 42 42 42 42 42 42 42 42 42 42 42 42 42 42 13 42 42 42 42 42 42 42 42 42 42 42 42 42 42 42 42 12 23 16 16 16 16 43 16 16 16 16 24 12 42 42 42 42 42 42 42 42 42 12 12 21 17 17 17 17 17 22 12 12 42 42 42 42 42 42 42 42 12 12 14
14 42 42 42 42 42 42 42 42 42 42 42 12 12 42 42 42 42 42 42 42 42 42 42 42 42 42 42 42 42 42 42 42 42 42 42 42 42 42 12 42 42 42 42 42 42 42 42 42 42 42 42 42 42 42 42 12 12 23 16 16 16 43 16 16 16 24 12 12 42 42 42 42 42 42 42 42 42 12 21 16 16 16 16 16 16 16 22 12 42 42 42 42 42 42 42 42 12 12 14
14 42 42 42 42 42 42 42 42 42 42 42 12 12 42 42 42 42 42 42 42 15 15 14 15 42 42 42 42 42 42 42 42 42 42 42 42 42 42 12 42 42 42 42 42 42 42 42 42 42 42 42 42 42 42 42 42 12 12 23 18 18 43 18 18 24 12 12 42 42 42 42 42 42 42 42 42 42 12 19 16 16 16 16 16 16 16 20 12 42 42 42 42 42 42 42 42 12 12 14
14 42 42 42 42 42 42 42 42 42 42 42 12 12 42 42 42 42 42 42 11 10 10 11 14 42 42 42 42 42 42 42 42 42 42 42 42 42 42 12 42 42 42 42 42 42 42 42 42 42 42 42 42 42 42 42 42 42 12 12 12 12 10 12 12 12 12 42 42 42 42 42 42 42 42 42 42 12 12 19 16 16 16 16 16 16 16 20 12 12 42 42 42 42 42 42 42 12 12 14
14 42 42 42 42 42 42 42 42 42 42 42 12 12 42 15 14 15 14 15 10 15 43 43 15 42 42 42 42 42 42 42 42 42 42 42 42 42 42 13 42 42 42 42 42 42 42 42 42 42 42 42 42 42 42 42 42 42 42 42 42 12 10 12 42 13 13 42 42 42 42 42 42 42 42 42 42 12 12 19 16 16 16 16 16 16 16 20 12 12 42 42 42 42 42 42 42 12 12 14
14 42 42 42 42 42 42 42 42 42 42 42 12 12 42 15 43 43 43 14 11 15 43 43 15 42 42 42 42 42 42 42 42 42 42 42 42 42 42 12 42 42 42 42 42 42 42 42 42 42 42 42 42 13 42 42 42 42 42 42 42 42 11 42 42 42 42 42 42 42 42 42 42 42 42 42 42 12 12 19 16 16 16 16 16 16 16 20 12 12 42 42 42 42 42 42 42 12 12 14
14 42 42 42 42 42 42 42 42 42 42 42 12 12 12 15 14 15 14 14 11 14 15 15 15 42 42 42 42 42 42 42 42 42 42 42 42 42 42 13 42 42 42 42 42 42 42 42 42 42 42 42 42 42 42 42 42 42 42 42 42 42 10 42 42 42 42 42 42 42 42 42 42 42 42 42 42 42 12 19 16 16 16 16 16 16 16 20 12 42 42 42 42 42 42 42 42 12 12 14
14 42 42 42 42 42 42 42 42 42 42 42 42 12 13 10 11 11 10 11 11 10 11 11 10 10 11 11 10 10 11 10 10 11 11 11 10 10 10 10 11 11 42 10 10 11 11 11 10 11 10 10 11 10 11 11 10 11 10 10 11 10 10 11 10 11 11 10 10 11 11 10 11 10 10 10 10 11 12 23 16 16 16 16 16 16 16 24 12 42 42 42 42 42 42 42 42 12 12 14
14 42 42 42 42 42 42 42 42 42 42 42 42 13 12 10 15 43 43 43 11 11 43 43 14 42 42 11 42 10 11 42 42 42 42 42 42 42 42 42 42 42 42 42 42 42 42 42 11 42 42 42 42 42 42 42 42 42 42 42 11 42 10 42 42 42 42 42 42 42 42 42 42 42 42 10 42 11 12 12 23 18 18 18 18 18 24 12 12 42 42 42 42 42 42 42 42 12 12 14
14 42 42 42 42 42 42 42 42 42 42 42 42 42 42 11 14 43 43 43 10 15 15 14 14 42 42 11 42 10 10 42 42 42 42 42 42 42 42 42 42 42 42 42 42 42 42 42 11 42 42 42 42 42 42 42 42 42 42 42 10 42 11 42 42 42 42 42 42 42 42 42 42 42 42 10 11 11 42 12 12 12 12 12 12 12 12 12 42 42 42 42 42 42 42 42 42 12 12 14
14 42 42 42 42 42 42 42 42 42 42 42 42 42 42 10 15 15 14 14 11 42 42 42 42 42 42 11 42 11 10 42 42 42 42 42 42 42 42 42 42 42 42 42 42 42 42 42 10 42 42 42 42 42 42 42 42 13 13 42 11 42 10 42 42 42 42 42 42 42 42 42 42 42 42 11 43 11 42 42 42 42 10 10 12 42 42 42 42 42 42 42 42 42 42 42 42 12 42 14
14 42 42 42 42 42 42 42 42 42 42 42 42 42 42 10 42 42 42 42 11 42 42 42 42 42 42 10 42 11 11 42 42 42 42 42 42 42 42 42 42 42 42 42 42 42 42 42 11 42 42 42 42 42 42 42 42 12 12 42 11 42 11 42 42 42 42 42 42 42 42 14 15 15 15 11 43 10 42 42 42 42 10 11 42 42 42 42 42 42 42 42 42 42 42 42 42 12 42 14
14 42 42 42 42 42 42 42 42 42 42 42 42 42 42 10 11 11 10 10 11 11 10 11 10 11 11 10 10 10 10 10 10 11 42 10 10 10 10 10 11 10 10 11 11 11 11 11 10 11 10 10 10 10 11 11 10 11 11 10 10 11 10 11 10 11 11 10 10 11 10 10 11 10 11 11 11 11 11 10 10 10 11 11 42 42 42 42 42 42 42 42 42 42 42 42 42 12 42 14
14 42 42 42 42 42 42 42 42 42 42 42 42 42 42 10 42 42 42 42 42 42 42 42 42 42 42 10 42 11 10 42 42 42 42 42 42 42 42 42 42 42 42 42 42 42 42 42 11 42 42 42 42 42 42 42 42 12 12 42 10 42 10 42 42 42 42 42 42 42 42 14 43 43 15 11 15 11 42 42 42 42 11 11 42 42 42 42 42 42 42 42 42 42 42 42 42 12 42 14
14 42 42 42 42 42 42 42 42 42 42 42 42 42 42 10 42 42 42 42 42 42 42 42 42 42 42 10 42 11 10 42 42 42 42 42 42 42 42 42 42 42 42 42 42 42 42 42 11 42 42 42 42 42 42 42 42 13 12 42 10 42 11 42 42 42 42 42 42 42 42 14 43 43 14 10 11 11 10 10 11 42 11 11 42 42 42 42 42 42 42 42 42 42 42 42 42 12 42 14
14 42 42 42 42 42 42 42 42 42 42 42 42 42 42 10 42 42 42 42 42 42 42 42 42 42 42 42 42 10 11 42 42 42 42 42 42 42 42 42 42 42 42 42 42 42 42 42 10 42 42 42 42 42 42 42 42 12 12 42 10 42 11 42 42 42 42 42 42 42 42 15 14 14 14 14 15 11 42 42 42 42 11 11 42 42 42 42 42 42 42 42 42 42 42 42 42 12 42 14
14 42 42 42 42 42 42 42 42 42 42 42 42 42 42 11 42 42 42 42 42 42 42 42 42 42 42 11 42 11 10 42 42 42 42 42 42 42 42 42 42 42 42 42 42 42 42 42 10 42 42 42 42 42 42 42 12 13 12 13 10 13 10 13 12 42 42 42 42 42 42 42 42 42 42 42 42 11 42 42 42 42 11 10 42 42 42 42 42 42 42 42 42 42 42 42 42 12 42 14
14 42 42 42 42 42 42 42 42 42 42 42 42 42 42 10 42 42 42 42 42 42 42 42 42 42 42 11 42 10 10 42 42 42 42 42 42 42 42 42 42 42 42 42 42 42 42 42 11 42 42 42 42 42 42 42 12 13 13 13 10 12 11 13 12 42 42 42 42 42 42 42 42 42 42 42 42 11 42 42 42 42 11 11 42 42 42 42 42 42 42 42 42 42 42 42 42 12 42 14
14 42 42 42 42 42 42 42 42 42 42 42 42 42 42 11 42 42 42 42 42 42 12 13 42 42 42 10 42 10 10 42 42 42 42 42 42 42 42 42 42 42 42 42 42 42 42 42 10 42 42 42 42 42 42 42 13 13 13 12 10 13 11 13 12 42 42 42 42 42 42 42 42 42 42 42 42 11 42 42 42 42 10 11 42 42 42 42 42 42 42 42 42 42 42 42 42 12 42 14
14 42 42 42 42 42 42 42 42 42 42 42 42 42 42 10 42 42 42 42 42 42 12 12 42 42 42 10 42 11 11 42 42 42 42 42 42 42 42 42 42 42 42 42 42 42 42 42 10 42 42 42 42 42 42 42 13 42 42 42 10 42 10 42 42 42 42 42 42 42 42 42 42 42 42 42 42 10 42 42 42 42 11 10 42 42 42 42 42 42 42 42 42 42 42 42 42 12 12 14
14 42 42 42 42 42 42 42 42 42 42 42 42 42 42 10 42 42 42 42 42 42 12 12 42 42 42 10 42 10 10 42 42 42 42 42 42 42 42 42 42 42 42 42 42 42 42 42 11 42 42 42 42 42 42 42 12 42 42 42 10 42 11 42 42 42 42 42 42 42 42 42 42 42 42 42 42 11 42 42 42 42 10 10 42 42 42 42 42 42 42 42 42 42 42 42 42 42 13 14
14 42 42 42 42 42 42 42 42 42 42 42 42 42 42 10 42 42 42 42 42 42 12 12 42 42 42 11 42 11 11 42 42 42 42 42 42 42 42 42 42 42 42 42 42 42 42 42 10 42 42 42 42 42 42 42 13 42 42 42 11 42 10 42 42 42 42 42 42 42 42 42 42 42 42 42 42 11 42 42 42 42 10 11 42 42 42 42 42 42 42 42 42 42 42 42 42 42 13 14
14 42 42 42 42 42 42 42 42 42 42 42 42 42 42 11 12 12 12 12 12 12 13 12 42 42 42 10 42 11 10 42 42 42 42 42 42 42 42 42 42 42 42 42 42 42 42 42 11 42 42 42 42 42 42 42 13 42 42 42 11 42 10 42 42 42 42 42 42 42 42 42 42 42 42 42 42 10 42 42 42 42 10 10 42 42 42 42 42 42 42 42 42 42 42 42 42 42 12 14
14 42 42 42 42 42 42 42 42 42 42 42 42 42 42 11 42 42 42 42 42 42 42 12 13 42 42 11 13 10 10 42 42 42 42 42 42 42 42 42 42 42 42 42 42 42 42 42 10 42 42 42 42 42 42 42 13 42 42 42 10 42 11 42 42 42 42 42 42 42 42 42 42 42 42 42 42 11 42 42 42 42 10 10 42 42 42 42 42 42 42 42 42 42 42 42 42 42 13 14
14 42 42 42 42 42 42 42 42 42 42 42 42 42 42 42 42 42 42 42 42 42 42 42 13 42 42 10 42 11 11 42 42 42 42 42 42 42 42 42 42 42 42 42 42 42 42 42 10 42 42 42 42 42 42 42 12 42 42 42 11 42 10 42 42 42 42 42 42 42 42 42 42 42 42 42 42 10 42 42 42 42 10 10 42 42 42 42 42 42 42 42 42 42 42 42 42 42 42 14
14 42 42 42 42 42 42 42 42 42 42 42 42 42 42 11 42 42 42 42 13 12 12 42 13 12 42 11 42 11 11 42 42 42 42 42 42 42 42 42 42 42 42 42 42 42 42 42 11 42 42 42 42 42 42 42 12 42 42 42 11 42 11 42 42 42 42 42 42 42 42 42 42 42 42 42 42 11 42 42 42 42 10 11 42 42 42 42 42 42 42 42 42 42 42 42 42 42 42 14
14 13 12 12 12 42 42 42 42 42 42 42 42 42 42 11 11 13 42 42 13 42 12 42 42 13 42 10 42 11 11 42 42 42 42 42 42 42 42 42 42 42 42 42 42 42 42 42 10 42 42 42 42 42 42 42 12 42 42 42 11 42 11 42 42 42 42 42 42 42 42 42 42 42 42 42 42 10 42 42 42 42 11 11 42 42 42 42 42 42 42 42 42 42 42 42 42 42 42 14
14 12 12 13 12 13 12 13 13 12 42 42 42 42 42 11 42 13 42 42 12 42 12 13 13 12 42 11 42 11 10 42 42 42 42 42 42 42 42 42 42 42 42 42 42 42 42 42 10 13 12 13 12 12 12 12 13 42 42 42 10 42 11 42 42 42 42 42 42 42 42 42 42 42 42 42 42 11 42 42 42 42 10 10 42 42 42 42 42 42 42 42 42 42 42 42 42 42 42 14
14 12 13 13 12 12 13 13 12 13 42 42 42 42 42 10 42 13 13 42 13 13 42 42 42 42 42 10 42 11 11 42 42 42 42 42 42 42 42 42 42 42 42 42 42 42 42 42 10 42 42 42 42 13 12 12 13 13 12 12 11 42 10 42 42 42 42 42 42 42 42 42 42 42 42 42 42 11 42 42 42 42 11 11 42 42 42 42 42 42 42 42 42 42 42 42 42 42 42 14
14 12 12 13 13 13 12 13 12 12 42 42 42 42 42 10 42 42 13 42 42 13 42 42 42 42 42 11 42 10 10 42 42 42 42 42 42 42 42 42 42 42 42 42 42 42 42 42 10 42 42 42 42 42 42 42 42 42 42 42 11 42 11 42 42 42 42 42 42 42 42 42 42 42 42 42 42 11 42 42 42 42 10 10 42 42 42 42 42 42 42 42 42 42 42 42 42 42 42 14
14 13 12 13 13 13 13 13 12 13 10 10 10 10 11 11 42 42 12 12 12 12 42 42 42 42 42 10 42 11 11 42 42 42 42 42 42 42 42 42 42 42 42 42 42 42 42 42 11 42 42 42 42 42 42 42 42 42 42 42 10 42 11 42 42 42 42 42 42 42 42 42 42 42 42 42 42 10 42 42 42 42 10 10 42 42 42 42 42 42 42 42 42 42 42 42 42 42 42 14
14 12 13 12 13 12 12 13 13 13 42 42 42 42 42 11 42 42 42 42 42 42 42 42 42 42 42 10 42 10 11 42 42 42 42 42 42 42 42 42 42 42 42 42 42 42 42 42 10 42 42 42 42 42 42 42 42 42 42 42 10 42 11 42 42 42 42 42 42 42 42 42 42 42 42 42 42 11 42 42 42 42 11 11 42 42 42 42 42 42 42 42 42 42 42 42 42 42 42 14
14 13 13 13 12 13 13 42 42 42 42 42 42 42 42 10 42 42 42 42 42 42 42 42 42 42 42 11 42 10 11 13 12 12 42 42 42 42 42 42 42 42 42 12 42 42 42 33 33 33 42 42 42 42 42 42 42 42 42 42 10 42 10 42 42 42 42 42 42 42 42 42 42 42 42 42 42 10 42 42 42 42 10 11 42 42 42 42 42 42 42 42 42 42 42 42 42 42 42 14
14 42 42 42 42 13 12 42 42 42 42 42 42 42 42 11 42 42 42 42 42 42 42 42 42 42 42 10 42 11 11 12 13 13 42 42 42 42 42 42 42 42 42 13 33 33 33 33 33 33 33 33 33 42 42 42 42 42 42 42 10 42 11 42 42 42 42 42 42 42 42 42 42 42 42 42 42 10 42 42 42 42 11 11 42 42 42 42 42 42 42 42 42 42 42 42 42 42 42 14
14 42 42 42 42 13 12 42 42 42 42 42 42 42 42 10 42 42 42 42 42 42 42 42 42 42 42 11 42 10 11 42 42 42 42 42 42 42 42 42 42 42 42 33 33 29 25 25 25 25 25 30 33 33 42 42 42 42 42 42 11 42 11 42 42 42 42 42 42 42 42 42 42 42 42 42 42 10 42 42 42 42 11 11 42 42 42 42 42 42 42 42 42 42 42 42 42 42 42 14
14 42 42 42 42 12 13 42 42 42 42 42 42 42 42 10 42 42 42 42 42 42 42 42 42 42 42 11 42 11 10 42 42 42 42 42 42 42 42 42 42 12 12 33 29 16 16 16 16 16 16 16 30 33 42 42 42 42 42 42 10 42 11 42 42 42 42 42 42 42 42 42 42 42 42 42 42 10 42 42 42 42 10 10 42 42 42 42 42 42 42 42 42 42 42 42 42 42 42 14
14 42 42 42 42 13 12 42 42 42 42 42 42 42 42 11 42 42 42 42 42 42 42 42 42 42 42 10 42 10 10 42 42 42 42 42 42 42 42 42 42 42 42 33 27 16 16 16 16 16 16 16 28 33 42 42 42 42 42 42 10 42 11 42 42 42 42 42 42 42 42 42 42 42 42 42 42 11 42 42 42 42 10 10 42 42 42 42 42 42 42 42 42 42 42 42 42 42 42 14
14 42 42 42 42 42 42 42 42 42 42 42 42 42 42 11 42 42 42 42 42 42 42 42 42 42 42 11 42 11 10 42 42 42 42 42 42 42 42 42 42 42 33 33 27 16 16 16 16 16 16 16 28 33 33 42 42 42 42 42 10 42 10 42 42 42 42 42 42 42 42 42 42 42 42 42 42 11 42 42 42 42 11 10 42 42 42 42 42 42 42 42 42 42 42 42 42 42 42 14
14 42 42 42 42 42 42 42 42 42 42 42 42 42 42 10 42 42 42 42 42 42 42 42 42 42 42 10 42 11 10 42 42 42 42 42 42 42 42 42 42 42 33 33 27 16 16 16 16 16 16 16 28 33 33 42 42 42 42 42 11 42 11 42 42 42 42 42 42 42 42 42 42 42 42 42 42 10 42 42 42 42 10 10 42 42 42 42 42 42 42 42 42 42 42 42 42 42 42 14
14 42 42 42 42 42 42 42 42 42 42 42 42 42 42 11 42 42 42 42 42 42 42 42 42 42 42 11 42 10 11 42 42 42 42 42 42 42 42 42 42 42 33 33 27 16 16 16 16 16 16 16 28 33 33 42 42 42 42 42 11 42 11 42 42 42 42 42 42 42 42 42 42 42 42 42 42 10 42 42 42 42 11 10 42 42 42 42 42 42 42 42 42 42 42 42 42 42 42 14
14 42 42 42 42 42 42 42 42 42 42 42 42 42 42 10 42 42 42 42 42 42 42 42 42 42 42 10 42 10 11 42 42 42 42 42 42 42 42 42 42 42 42 33 27 16 16 16 16 16 16 16 28 33 42 42 42 42 42 42 11 42 11 42 42 42 42 42 42 42 42 42 42 42 42 42 42 11 42 42 42 42 11 11 42 42 42 42 42 42 42 42 42 42 42 42 42 42 42 14
14 42 42 42 42 42 42 42 42 12 12 13 13 13 42 10 42 42 42 42 42 42 42 42 42 42 42 10 42 10 11 42 42 42 42 42 42 42 13 42 42 42 42 33 31 16 16 16 16 16 16 16 32 33 42 42 42 42 42 42 10 42 10 42 42 42 42 42 42 42 42 42 42 42 42 42 42 10 42 42 42 42 10 11 42 42 42 42 42 42 42 42 42 42 42 42 42 42 42 14
14 42 42 42 42 42 42 42 42 12 13 12 13 13 12 10 42 42 42 42 42 42 42 42 42 42 42 10 42 11 10 42 42 42 42 42 42 42 12 42 42 42 42 33 33 31 26 26 26 26 26 32 33 33 42 42 42 42 42 42 11 42 10 42 42 42 42 42 42 42 42 42 42 42 42 42 42 10 42 42 42 42 11 11 42 42 42 42 42 42 42 42 42 42 42 42 42 42 42 14
14 42 42 42 42 42 42 42 42 12 13 13 13 12 42 11 42 42 42 42 42 42 42 42 42 42 42 42 12 12 12 42 42 42 42 42 42 42 12 12 13 12 12 13 33 33 33 33 33 33 33 33 33 42 42 42 42 42 42 42 11 42 11 42 42 42 42 42 42 42 42 42 42 42 42 42 42 11 42 42 42 42 11 10 42 42 42 42 42 42 42 42 42 42 42 42 42 42 42 14
14 42 42 42 42 42 42 42 42 12 13 42 42 42 42 10 42 42 42 42 42 42 42 42 42 42 38 34 34 34 39 42 42 42 42 42 42 42 42 42 42 42 42 42 42 42 42 33 33 33 42 42 42 42 42 42 42 15 14 15 10 15 10 15 42 42 42 42 42 42 42 42 42 42 42 42 42 11 12 13 42 42 10 10 42 42 42 42 42 42 42 42 42 42 42 42 42 42 42 14
14 42 42 42 42 42 42 42 42 12 12 42 42 42 42 11 42 42 42 42 42 42 42 38 34 34 33 33 33 33 33 39 42 42 42 42 42 42 42 42 42 42 42 42 42 42 42 42 11 42 42 42 42 42 42 42 42 14 42 42 11 42 11 15 42 42 42 42 42 42 42 42 42 42 42 42 42 11 13 13 42 42 11 11 42 42 42 42 42 42 42 42 42 42 42 42 42 42 42 14
14 12 13 12 12 13 42 42 42 42 42 42 42 42 42 11 42 42 42 42 42 42 38 33 29 25 25 25 25 25 30 33 39 42 42 42 42 42 42 42 42 42 42 42 42 42 42 42 10 42 42 42 42 42 42 42 42 15 42 42 10 42 11 14 42 42 42 42 42 42 42 42 42 42 42 42 42 10 13 12 42 42 10 10 42 42 42 42 42 42 42 42 42 42 42 42 42 42 42 14
14 13 13 13 12 13 42 42 42 42 42 42 42 42 42 11 42 42 42 42 42 38 33 29 16 16 16 16 16 16 16 30 33 39 42 42 42 42 42 42 42 42 42 42 42 42 42 42 10 42 42 42 42 42 42 42 42 15 42 42 11 42 11 15 42 42 42 42 42 42 42 42 12 12 12 13 12 11 13 13 42 42 10 10 42 42 42 42 42 42 42 42 42 42 42 42 42 42 42 14
14 12 12 12 13 13 42 42 42 42 42 42 42 42 42 11 42 42 42 42 42 36 29 16 16 16 16 16 16 16 16 16 30 37 42 42 42 42 42 42 42 42 42 42 42 42 42 42 11 42 42 42 42 42 42 42 42 15 42 42 10 42 10 14 42 42 42 42 42 42 42 42 42 42 42 42 13 11 13 13 42 42 11 10 42 42 42 42 42 42 42 42 42 42 42 42 42 42 42 14
14 42 42 42 42 42 42 42 42 42 42 42 42 42 42 11 42 42 42 42 38 33 27 16 16 16 16 16 16 16 16 16 28 33 39 42 42 42 42 42 42 42 42 42 42 42 42 42 10 42 42 42 42 42 42 42 42 14 42 42 11 42 11 14 42 42 42 42 42 42 42 42 42 42 42 42 12 10 12 13 42 42 10 10 42 42 42 42 42 42 42 42 42 42 42 42 42 42 42 14
14 42 42 42 42 42 42 42 42 42 42 42 42 42 42 10 42 42 42 42 36 29 16 16 16 16 16 16 16 16 16 16 16 30 37 42 42 42 42 42 42 42 42 42 42 42 42 42 10 42 42 12 13 13 42 42 42 15 15 15 11 15 11 15 42 42 42 42 42 42 42 42 42 42 42 42 12 11 42 42 42 42 10 10 42 42 42 42 42 42 42 42 42 42 42 42 42 42 42 14
14 42 42 42 42 42 42 42 42 42 42 42 42 42 42 10 42 42 42 42 36 31 16 16 16 16 16 16 16 16 16 16 16 32 37 42 42 42 42 42 42 42 42 42 42 42 42 42 11 42 42 42 42 42 42 42 42 42 42 42 10 42 10 42 42 42 42 42 42 42 42 42 42 42 42 42 13 10 42 42 42 42 11 11 42 42 42 42 42 42 42 42 42 42 42 42 42 42 42 14
14 42 42 42 42 42 42 42 42 42 42 42 42 42 38 33 39 42 42 42 36 33 27 16 16 16 16 16 16 16 16 16 28 33 41 42 42 42 42 42 42 42 42 42 42 42 42 42 10 42 42 42 42 42 42 42 42 42 42 42 11 42 10 42 42 42 42 42 42 42 42 42 42 42 42 42 12 10 42 42 42 42 10 10 42 42 42 42 42 42 42 42 42 42 42 42 42 42 42 14
14 42 42 42 42 42 42 42 42 42 42 38 34 34 33 33 33 34 34 34 33 33 27 16 16 16 16 16 16 16 16 16 28 37 42 42 42 42 42 42 42 42 42 42 42 42 42 42 10 42 42 42 42 42 42 42 42 42 42 42 11 42 11 42 42 42 42 42 42 42 42 42 42 42 42 42 33 11 33 42 42 42 11 10 42 42 42 42 42 42 42 42 42 42 42 42 42 42 42 14
14 42 42 42 42 42 42 42 42 42 38 33 16 16 16 16 16 16 16 33 33 33 31 16 16 16 16 16 16 16 16 16 32 37 42 42 42 42 42 42 42 42 42 42 42 42 42 42 10 42 42 42 42 42 42 42 42 42 42 42 10 42 10 42 42 42 42 42 42 42 42 42 42 33 33 33 33 33 33 33 33 33 10 10 42 42 42 42 42 42 42 42 42 42 42 42 42 42 42 14
14 42 42 42 42 42 42 42 42 38 33 16 16 16 16 16 16 16 16 16 33 33 33 31 16 16 16 16 16 16 16 32 33 41 42 42 42 42 42 42 42 42 42 42 42 42 42 42 11 42 42 42 42 42 42 42 42 42 42 42 10 42 11 42 42 42 42 42 42 42 42 42 33 33 16 16 33 33 33 16 16 33 11 11 42 42 42 42 42 42 42 42 42 42 42 42 42 42 42 14
14 42 42 42 42 42 42 42 42 36 16 16 16 16 16 16 16 16 16 16 16 33 33 33 31 26 26 26 26 26 32 33 41 42 42 42 42 42 42 42 42 42 42 42 42 42 42 42 10 42 42 42 42 42 42 42 42 42 42 42 10 42 10 42 42 42 42 42 42 42 42 42 33 16 16 16 33 33 16 16 16 33 10 11 42 42 42 42 42 42 42 42 42 42 42 42 42 42 42 14
14 42 42 42 42 42 42 42 42 36 16 16 16 16 16 16 16 16 16 16 16 33 33 35 35 35 33 33 33 11 33 37 42 42 42 42 42 42 42 42 42 42 12 12 12 12 42 42 10 42 42 42 42 42 42 42 42 42 42 42 10 42 10 42 42 42 42 42 42 42 42 42 33 16 16 16 33 33 16 16 16 33 33 10 42 42 42 42 42 42 42 42 42 42 42 42 42 42 42 14
14 42 42 42 42 42 42 42 38 33 16 16 16 16 16 16 16 16 16 16 16 33 37 42 42 42 40 10 35 10 10 15 14 15 42 42 42 42 42 42 42 42 42 42 42 42 42 42 11 42 42 42 42 42 42 42 42 42 42 42 11 42 10 42 42 42 42 42 42 42 42 33 33 16 16 16 33 33 16 16 16 33 33 11 42 42 42 42 42 42 42 42 42 42 42 42 42 42 42 14
14 42 42 42 42 42 42 42 36 16 16 16 16 16 16 16 16 16 16 16 16 16 37 42 42 42 42 11 42 10 10 43 43 14 15 42 42 42 42 42 42 42 42 42 42 42 42 12 11 42 42 42 42 42 42 42 42 42 42 42 10 42 10 42 42 42 13 12 12 12 42 33 16 16 16 16 33 33 33 16 16 33 33 10 42 42 42 42 42 42 42 42 42 42 42 42 42 42 42 14
14 42 42 42 42 42 42 42 40 33 16 16 16 16 16 16 16 16 16 16 16 33 41 42 42 42 42 11 42 11 11 15 14 15 15 42 42 42 42 42 42 42 42 42 42 42 42 12 10 42 42 42 42 42 42 42 42 42 42 42 10 42 10 42 42 42 42 42 42 42 42 33 33 16 16 16 33 33 33 33 16 33 33 11 42 42 42 42 42 42 42 42 42 42 42 42 42 42 42 14
14 42 42 42 42 42 42 42 42 36 16 16 16 16 16 16 16 16 16 16 16 37 42 42 42 42 42 11 42 11 10 10 11 43 15 42 42 42 42 42 42 42 42 42 42 42 42 13 10 42 42 42 42 42 42 42 42 42 42 42 11 42 11 42 42 42 42 42 42 42 42 42 33 33 33 33 33 33 33 33 33 33 33 11 42 42 42 42 42 42 42 42 42 42 42 42 42 42 42 14
14 42 42 42 42 42 42 42 42 36 16 16 16 16 16 16 16 16 16 16 16 33 10 11 11 11 10 11 10 11 10 10 10 10 11 11 11 11 11 11 10 11 11 11 11 11 10 10 11 11 11 11 10 10 11 10 10 11 11 10 10 11 11 10 11 11 10 11 10 11 10 11 33 33 33 16 16 16 16 33 33 33 33 33 42 42 42 42 42 42 42 42 42 42 42 42 42 42 42 14
14 42 42 42 42 42 42 42 42 40 33 16 16 16 16 16 16 16 16 16 33 41 42 42 42 42 13 13 13 11 11 15 14 15 12 12 11 42 42 42 42 42 42 42 42 42 42 12 13 42 42 42 42 42 42 42 42 42 42 42 42 42 42 42 42 42 42 42 42 42 42 42 33 33 16 16 16 16 16 16 16 33 43 33 33 33 42 42 42 42 42 42 42 42 42 42 42 42 42 14
14 42 42 42 42 42 42 42 42 42 40 33 16 16 16 16 16 16 16 33 41 42 42 42 42 42 42 42 42 11 10 43 43 14 12 13 10 42 42 42 42 42 42 42 42 42 42 42 42 42 42 42 42 42 42 42 42 42 42 42 42 42 42 42 42 42 42 42 42 42 42 42 42 33 33 33 33 16 33 33 16 16 43 16 16 33 42 42 42 42 42 42 42 42 42 42 42 42 42 14
14 42 42 42 42 42 42 42 42 42 42 40 33 35 33 16 33 35 33 41 42 42 42 42 42 42 42 42 42 10 11 43 43 14 42 42 11 42 42 42 42 42 42 42 42 42 42 42 42 42 42 42 42 42 42 42 42 42 42 42 42 42 42 42 42 42 42 42 42 42 42 42 42 42 42 42 33 33 33 33 16 16 43 16 16 33 33 42 42 42 42 42 42 42 42 42 42 42 42 14
14 42 42 42 42 42 42 42 42 42 42 42 14 42 36 33 37 42 14 42 42 42 42 42 42 42 42 42 42 10 10 15 15 15 42 42 10 42 42 42 42 42 42 42 42 42 42 42 42 42 42 42 42 42 42 42 42 42 42 42 42 42 42 42 42 42 42 42 42 42 42 42 42 42 42 42 42 42 33 16 16 16 43 16 16 16 33 12 42 42 42 42 42 42 42 42 42 12 13 14
14 42 42 42 42 42 42 42 42 42 42 42 14 14 14 10 14 14 14 42 42 42 42 42 42 42 42 42 42 11 11 11 42 42 42 42 10 42 42 42 42 42 42 42 42 42 42 42 42 42 42 42 42 42 42 42 42 42 42 42 42 42 42 42 42 42 42 42 42 42 42 42 42 42 42 42 42 42 33 33 16 16 16 16 16 33 33 42 42 42 42 42 42 42 42 42 42 12 13 14
14 42 42 42 42 42 42 42 42 42 42 42 14 43 43 43 43 43 14 42 42 42 42 42 42 42 42 42 42 10 42 42 42 42 42 42 10 42 42 42 42 42 42 42 42 42 42 42 42 42 42 42 42 42 42 42 42 42 42 42 42 42 42 42 42 42 42 42 42 42 42 42 42 42 42 42 42 42 42 33 16 16 16 16 16 33 42 42 42 42 42 42 42 42 42 42 42 42 42 14
14 42 42 42 42 42 42 42 42 42 42 42 14 43 43 43 43 43 15 42 42 42 42 42 42 42 42 42 42 11 42 42 42 42 42 42 10 42 42 42 42 42 42 42 42 42 42 42 42 42 42 42 42 42 42 42 42 42 42 42 42 42 42 42 42 42 42 42 42 42 42 42 42 42 42 42 42 42 42 33 33 33 16 33 33 33 42 42 42 42 42 42 42 42 42 42 42 42 42 14
14 42 42 42 42 42 42 42 42 42 42 42 14 14 15 43 15 14 15 42 42 42 42 42 42 42 42 42 38 43 39 42 42 42 42 42 10 42 42 42 42 42 42 42 42 42 42 42 42 42 42 42 42 42 42 42 42 42 42 42 42 42 42 42 42 42 42 42 42 42 42 42 42 42 42 42 42 42 42 42 42 33 33 33 42 42 42 42 42 42 42 42 42 42 42 42 42 42 42 14
14 12 12 12 12 12 12 12 12 42 42 42 42 42 42 43 42 42 42 42 42 42 42 42 42 42 38 34 33 43 33 34 39 42 42 42 11 42 42 42 42 42 42 42 42 42 42 42 42 42 42 42 42 42 42 42 42 42 42 42 42 42 42 42 42 42 42 42 42 42 42 42 42 42 42 42 42 42 42 42 42 42 42 42 42 42 42 42 42 42 42 42 13 42 42 42 42 42 42 14
14 12 12 12 12 42 12 12 12 42 42 42 42 42 42 43 42 42 42 42 42 42 42 42 42 42 36 16 16 43 16 16 37 42 42 42 10 42 42 42 42 42 42 42 42 42 42 42 42 42 42 42 42 42 42 42 42 42 42 42 42 42 42 42 42 42 42 42 42 42 42 42 42 42 42 42 42 42 42 42 42 42 42 42 42 42 42 42 42 42 42 42 12 42 42 42 42 42 42 14
14 12 12 12 12 12 12 12 12 42 42 42 42 42 42 43 42 42 42 42 42 42 42 42 42 38 33 16 16 43 16 16 33 39 42 42 11 42 42 42 42 42 42 42 42 42 42 42 42 42 42 42 42 42 42 42 42 42 42 42 42 42 42 42 42 42 42 42 42 42 42 42 42 42 42 42 42 42 42 42 42 42 42 42 42 42 42 42 42 42 42 42 42 42 42 42 42 42 42 14
14 12 12 12 12 12 12 12 12 42 42 42 42 42 42 43 42 42 42 42 42 42 42 42 42 36 16 16 16 43 16 16 16 37 42 42 11 42 42 42 42 42 42 42 42 42 42 42 42 42 42 42 42 42 42 42 42 42 42 42 42 42 42 42 42 42 42 42 42 42 42 42 42 42 42 42 42 42 42 42 42 42 42 42 42 42 42 42 42 42 42 42 42 42 42 42 42 42 42 14
14 12 12 42 12 12 12 12 12 12 12 43 43 43 43 43 42 42 42 42 42 42 42 42 42 40 33 16 16 16 16 16 33 41 42 42 11 42 42 42 42 42 42 42 42 42 42 42 42 42 42 42 42 42 42 42 42 42 42 42 42 42 42 42 42 42 42 42 42 42 42 42 42 42 42 42 42 42 42 42 42 42 42 42 42 42 42 42 42 42 42 42 42 42 42 42 42 42 42 14
14 12 12 12 12 12 12 12 12 42 42 42 42 42 42 42 42 42 42 42 42 42 42 42 42 42 36 16 16 16 16 16 37 42 42 42 10 42 42 42 42 42 42 42 42 42 42 42 42 42 42 42 42 42 42 42 42 42 42 42 42 42 42 42 42 42 42 42 42 42 42 42 42 42 42 42 42 42 42 42 42 42 42 42 42 42 42 42 42 42 42 42 42 42 42 42 42 42 42 14
14 12 12 12 12 12 42 12 12 42 42 42 42 42 42 42 42 42 42 42 42 42 42 42 42 42 40 35 33 16 33 35 41 42 42 42 10 42 42 42 42 42 42 42 42 42 42 42 42 42 42 42 42 42 42 42 42 42 42 42 42 42 42 42 42 42 42 42 42 42 42 42 42 42 42 42 42 42 42 42 42 42 42 42 42 42 42 42 42 42 42 42 42 42 42 42 42 42 42 14
14 12 12 12 12 12 12 12 12 42 42 42 42 42 42 42 42 42 42 42 42 42 42 42 42 42 42 42 40 33 41 42 42 42 42 42 10 42 42 42 42 42 42 42 42 42 42 42 42 42 42 42 42 42 42 42 42 42 42 42 42 42 42 42 42 42 42 42 42 42 42 42 42 42 42 42 42 42 42 42 42 42 42 42 42 42 42 42 42 42 42 42 42 42 42 42 42 42 42 14
14 42 42 42 42 42 42 42 42 42 42 42 42 42 42 42 42 42 42 42 42 42 42 42 42 42 42 42 42 33 42 42 42 42 42 42 11 42 42 42 42 42 42 42 42 42 42 42 42 42 42 42 42 42 42 42 42 42 42 13 13 13 13 13 13 13 13 13 13 13 13 13 13 13 42 42 42 42 42 42 42 42 42 42 42 42 42 42 42 42 42 42 42 42 42 42 42 42 42 14
14 42 42 42 42 42 42 42 42 42 42 42 42 42 42 42 42 42 42 42 42 42 42 42 42 42 42 42 42 33 42 42 42 42 42 42 10 42 42 42 42 42 42 42 42 42 42 42 42 42 42 42 42 42 42 42 42 42 42 13 13 42 13 13 13 13 13 42 13 13 13 13 13 13 42 42 42 42 42 42 42 42 42 42 42 42 42 42 42 42 42 42 42 42 42 42 42 42 42 14
14 42 42 42 42 42 42 42 42 42 42 42 42 42 42 42 42 42 42 42 42 42 42 42 42 42 42 42 42 33 42 42 42 42 42 42 10 42 42 42 42 42 42 42 42 42 42 42 42 42 42 42 42 42 42 42 42 42 42 13 13 13 13 13 13 13 13 13 43 43 43 13 13 13 42 42 42 42 42 42 42 42 42 42 42 42 42 42 42 42 42 42 42 42 42 42 42 42 42 14
14 42 42 42 42 42 42 42 42 42 42 42 42 42 42 42 42 42 42 42 42 42 42 42 42 42 42 12 13 33 42 42 42 42 42 42 11 42 42 42 42 42 42 42 42 42 42 42 42 42 42 42 42 42 42 42 42 42 42 13 13 13 13 13 13 13 13 13 13 13 43 13 13 13 42 42 42 42 42 42 42 42 42 42 42 42 42 42 42 42 42 42 42 42 42 42 42 42 42 14
14 42 42 42 42 42 42 42 42 42 42 42 42 42 42 42 42 42 42 42 42 42 42 42 42 42 42 12 13 33 42 42 42 42 42 42 10 42 42 42 42 42 42 42 42 42 42 42 42 42 42 42 42 42 42 42 42 42 42 13 13 13 42 13 13 13 13 13 13 13 43 13 13 13 42 42 42 42 42 42 42 42 42 42 42 42 42 42 42 42 42 42 42 42 42 42 42 42 42 14
14 42 42 42 42 42 42 42 42 42 42 42 42 42 42 42 42 42 42 42 42 42 38 34 34 34 34 34 34 33 34 34 34 34 34 34 10 34 34 34 34 34 34 34 34 34 34 34 34 34 34 10 10 10 10 10 10 42 42 13 13 13 13 13 13 13 13 13 43 43 43 42 13 13 42 42 42 42 42 42 42 42 42 42 42 42 42 42 42 42 42 42 42 42 42 42 42 42 42 14
14 42 42 42 42 42 42 42 42 42 42 42 42 42 42 42 42 42 42 42 42 42 16 16 16 16 16 16 16 16 16 16 16 16 16 16 16 16 16 16 16 16 16 16 16 16 16 16 16 16 16 42 42 42 42 42 10 10 10 13 13 13 13 13 13 13 13 13 42 13 13 13 13 13 42 42 42 42 42 42 42 42 42 42 42 42 42 42 42 42 42 42 42 42 42 42 42 42 42 14
14 14 14 14 14 14 14 14 14 14 14 14 14 14 14 14 14 14 14 14 14 14 14 14 14 14 14 14 14 14 14 14 14 14 14 14 14 14 14 14 14 14 14 14 14 14 14 14 14 14 14 14 14 14 14 14 14 14 14 14 14 14 14 14 14 14 14 14 14 14 14 14 14 14 14 14 14 14 14 14 14 14 14 14 14 14 14 14 14 14 14 14 14 14 14 14 14 14 14 14
