6 6 6 6 6 6 6 6 6 6 6 6 6 6 6 6
2 3 3 3 2 2 2 2 2 2 2 2 2 3 3 8
2 3 2 3 2 2 2 2 2 2 2 2 2 2 1 3
2 3 3 3 2 2 2 2 2 3 2 0 0 0 0 0
2 2 2 2 2 2 2 2 1 0 0 0 0 0 0 0
0 0 0 0 3 2 2 0 0 0 0 0 1 0 0 0
0 0 1 0 0 2 2 0 0 1 0 0 0 0 0 0
0 0 0 0 0 2 2 2 0 0 0 1 0 0 2 0
1 2 2 2 2 2 2 3 2 0 0 0 0 3 2 2
0 2 2 2 2 2 2 2 2 2 2 3 2 2 2 2
2 2 2 2 2 2 3 2 2 2 2 2 2 2 2 8
2 2 2 2 1 2 2 2 2 2 2 1 2 2 8 8