2 2 3 2 2 2 2 2 3 2 2 2 2 2 2 2 3 2 3 3 2 2 3 3 3 2 2 3 2 2 3 2 3 3 3 2 3 2 3 2 3 3 2 2 2 2 3 2 2 2 3 3 3 3 2 3 3 2 3 2 2 2 2 3 3 3 2 3 2 2 2 3 3 3 2 2 3 2 3 3 3 2 3 2 2 3 3 3 3 2 2 3 2 2 2 2 2 3 2 3
3 3 3 2 2 3 3 2 3 3 2 3 2 3 2 2 3 2 2 3 2 2 3 3 2 2 3 3 2 2 2 2 8 8 2 2 2 3 2 3 3 2 2 3 3 3 3 3 2 2 2 2 3 2 2 2 2 2 2 2 2 2 3 2 2 3 3 2 2 3 2 3 3 2 2 2 3 3 3 3 3 2 2 2 3 3 2 2 2 2 3 2 3 2 3 3 2 2 3 2
2 2 2 2 2 3 3 3 2 3 2 2 3 2 3 3 3 3 3 3 2 2 3 2 2 2 3 2 2 3 2 2 2 2 2 2 2 3 2 2 2 2 3 3 3 2 3 2 3 3 2 3 3 3 2 2 3 2 2 2 3 2 3 2 2 3 3 2 3 3 2 3 2 2 3 2 2 2 3 3 2 3 2 3 3 3 2 2 3 3 2 2 3 2 3 2 3 3 2 2
2 2 2 3 2 3 2 2 3 3 2 3 2 2 2 3 3 2 2 2 2 3 2 2 3 3 2 3 2 2 3 2 3 2 2 3 3 3 2 2 2 2 3 3 3 2 3 3 3 3 2 2 3 2 3 2 2 3 3 3 3 2 3 2 3 2 3 2 2 3 3 2 3 3 2 3 3 3 3 3 3 2 2 3 3 2 3 3 2 3 3 2 3 3 3 3 3 2 3 2
2 3 3 2 2 3 2 2 2 2 2 2 3 2 3 3 2 3 3 3 2 2 2 2 3 2 2 8 2 2 2 3 2 3 3 3 3 3 2 3 3 3 2 3 3 2 3 3 2 3 2 3 3 3 2 2 2 2 3 2 2 2 3 3 3 3 3 2 2 3 3 2 3 3 2 3 3 3 3 2 3 2 3 3 3 2 3 3 3 2 3 2 2 3 2 2 3 2 3 2
2 3 3 3 2 3 3 3 3 3 3 3 2 3 2 2 3 2 2 2 2 2 2 2 2 2 2 3 2 8 3 3 8 2 2 2 3 2 2 3 3 3 2 2 2 2 3 2 2 3 3 3 2 3 2 3 3 2 3 3 3 2 3 2 3 3 3 3 3 3 2 2 3 3 2 3 3 3 2 3 3 2 3 2 3 3 3 3 3 2 2 2 2 3 3 2 3 3 3 2
2 3 2 3 2 3 3 3 3 3 3 3 3 3 3 3 2 2 2 3 2 2 2 2 3 8 3 2 2 3 2 3 2 3 2 2 3 2 2 3 2 3 2 2 3 3 3 3 3 2 2 3 3 2 2 3 3 2 2 2 2 3 2 2 2 3 2 3 3 3 3 3 3 2 2 2 2 3 2 2 2 2 2 2 2 3 3 3 3 2 2 3 3 3 2 2 3 2 3 2
2 2 3 2 2 2 2 3 3 3 2 3 3 3 3 3 3 2 2 3 3 3 2 2 8 8 3 2 2 3 3 3 2 8 3 2 3 3 3 3 3 2 2 3 8 3 3 3 2 3 2 3 3 3 2 3 2 3 3 2 2 3 3 3 2 2 3 2 3 3 3 2 2 2 2 3 2 3 2 2 2 3 2 2 3 3 3 3 3 3 2 3 2 3 2 2 2 3 3 3
3 2 3 3 3 2 3 3 3 3 3 3 3 2 2 3 2 3 2 3 3 3 3 2 3 2 2 3 2 3 2 8 8 2 3 2 2 8 3 3 3 2 3 3 3 3 2 2 2 3 2 2 3 2 2 3 2 3 2 2 3 2 3 3 3 3 2 2 3 2 2 2 2 3 2 3 2 2 3 3 3 3 2 3 3 2 2 3 3 3 3 3 3 3 2 3 3 2 2 3
3 3 3 2 3 3 2 2 3 3 2 3 2 2 3 2 2 2 3 3 2 3 2 2 3 3 3 2 2 2 3 3 2 8 3 8 3 2 3 2 2 2 3 3 2 3 2 3 2 3 3 3 3 3 2 2 3 2 3 2 2 3 3 3 2 2 2 2 3 3 2 2 2 2 3 3 3 3 2 3 2 3 3 3 2 3 2 3 3 2 3 2 3 3 2 3 3 2 2 3
2 2 2 2 3 2 2 2 2 2 0 2 3 2 2 3 2 2 3 2 2 2 2 2 3 2 3 2 2 3 2 8 8 2 2 3 3 3 8 3 2 2 3 3 2 2 3 3 3 2 3 3 2 2 3 2 2 2 3 3 3 3 3 3 2 2 2 3 3 2 3 3 3 3 3 2 3 3 3 3 3 2 3 2 2 2 2 3 2 3 2 2 3 2 3 3 3 2 3 3
3 2 2 2 3 2 2 3 3 2 0 2 3 2 3 2 2 3 3 3 3 2 2 2 3 2 2 2 2 8 3 3 3 3 2 8 3 3 2 2 2 2 2 8 3 3 3 3 3 3 3 2 2 3 3 2 3 3 3 2 2 3 2 2 2 3 2 2 3 3 3 2 2 3 3 2 2 3 2 3 2 3 2 3 2 3 2 3 3 3 3 3 2 3 2 3 2 3 3 2
3 2 2 3 3 2 3 3 3 2 1 2 2 2 2 3 3 2 2 2 2 3 2 2 2 2 2 3 3 3 3 3 8 3 2 3 8 3 3 2 3 2 3 3 3 2 2 3 3 2 2 3 3 2 3 2 3 3 2 2 3 2 3 2 2 2 2 3 3 2 3 3 3 3 3 3 2 3 2 3 2 3 3 3 2 3 2 2 3 3 3 2 2 3 3 3 2 2 3 3
2 3 3 2 2 3 3 2 2 2 0 2 3 2 2 3 2 3 2 2 2 2 3 2 8 8 2 3 8 3 2 2 3 3 2 3 3 3 3 3 3 2 2 8 3 2 3 3 2 2 3 2 2 3 3 2 3 2 2 3 3 2 3 2 3 3 2 3 2 3 2 2 3 2 8 2 2 2 3 3 2 3 3 2 2 2 3 2 2 3 2 3 2 3 2 2 2 3 3 2
2 3 2 2 2 3 3 2 3 2 0 2 2 3 2 2 3 3 2 3 3 3 2 3 2 3 2 2 3 2 2 3 3 2 3 3 2 2 8 3 2 3 2 2 2 2 3 3 3 3 3 2 2 3 3 2 3 3 2 3 3 3 3 3 3 2 3 3 3 3 2 3 2 3 2 3 3 2 2 3 3 3 3 3 2 3 3 3 2 3 3 3 2 2 3 3 2 2 2 3
2 2 2 2 3 3 3 2 2 3 1 3 3 2 2 3 3 3 3 2 5 2 2 3 3 2 3 3 3 2 3 3 2 2 2 2 3 2 3 2 3 3 2 3 3 2 2 3 2 2 2 2 2 3 2 3 3 3 2 2 2 3 3 3 3 3 2 2 3 2 3 3 3 2 2 2 3 2 8 2 3 2 2 3 2 3 3 2 3 2 3 2 3 2 2 2 2 3 2 2
2 2 3 2 3 2 3 3 3 3 0 3 3 3 2 2 2 3 5 5 4 5 4 2 3 3 3 3 2 3 2 3 2 3 2 3 3 2 8 8 8 3 3 3 2 2 3 3 2 2 3 3 3 3 3 2 2 3 3 2 2 3 2 2 3 3 3 3 2 2 3 2 3 3 8 3 2 3 2 2 3 3 2 3 3 3 9 9 9 9 9 3 3 2 2 3 2 2 2 2
3 3 3 2 2 3 3 2 3 3 0 3 3 3 2 3 3 2 4 4 5 4 4 2 2 3 8 3 2 2 2 2 2 2 3 3 3 2 3 2 3 3 2 8 2 3 3 3 3 2 3 3 3 3 3 2 2 8 3 2 3 3 2 3 3 3 3 3 3 2 3 3 3 2 3 2 3 2 3 8 8 3 2 2 3 3 9 9 9 9 9 2 2 2 2 3 3 3 2 2
2 2 3 3 3 2 3 3 3 2 0 2 2 2 3 2 2 4 5 5 0 0 0 1 0 0 0 0 0 1 0 1 1 0 1 0 1 0 1 1 0 0 0 0 1 0 0 0 0 0 0 0 0 0 0 1 1 0 0 1 0 0 0 0 0 0 0 1 0 0 0 0 0 0 0 1 0 1 0 1 1 1 0 1 1 0 1 1 1 9 9 2 2 2 2 2 2 3 3 2
2 3 2 3 2 3 2 3 3 2 1 3 2 3 3 2 2 2 4 5 5 4 5 2 3 2 8 3 2 2 3 8 3 3 3 3 2 8 3 2 8 8 2 2 8 2 3 3 3 3 8 2 3 3 8 3 2 2 2 3 2 8 2 2 2 2 3 2 2 2 8 8 2 2 2 2 3 2 3 3 2 3 2 2 3 3 9 9 1 9 9 2 3 3 3 3 3 2 3 3
2 3 2 2 3 2 3 2 3 3 0 3 2 3 2 3 2 3 4 4 4 4 5 3 2 2 2 2 3 2 3 3 8 8 8 8 3 2 2 3 2 3 8 3 3 3 3 3 3 3 3 8 3 3 2 3 3 3 2 2 2 2 3 3 3 2 2 3 2 3 2 8 3 8 3 3 3 2 3 2 2 3 2 2 2 2 9 9 0 9 9 2 2 2 2 3 3 2 3 3
2 2 3 2 2 3 3 2 3 2 0 2 2 2 2 3 3 3 3 2 5 3 3 2 2 3 2 2 2 8 8 3 3 2 2 8 2 3 3 8 8 2 2 2 3 3 2 2 3 2 2 3 8 2 2 3 2 3 2 2 3 3 3 2 2 3 2 2 3 2 8 3 3 3 8 3 3 3 2 8 3 3 2 3 2 3 2 2 1 3 2 3 2 3 3 3 2 2 2 3
3 3 3 2 2 2 2 3 3 3 1 2 2 3 2 3 3 2 3 3 3 2 2 2 3 2 2 3 3 8 3 2 8 2 8 3 3 8 3 2 3 3 2 3 2 3 2 2 3 2 3 3 8 3 3 3 3 2 3 8 2 3 3 2 3 3 3 8 2 8 3 3 8 3 2 2 2 2 3 2 3 3 2 3 3 2 3 2 1 2 3 3 2 3 3 3 3 2 3 2
2 2 3 2 2 3 3 3 2 2 1 3 2 2 3 3 3 3 2 3 2 3 2 3 3 2 2 2 7 3 3 3 2 3 3 3 2 3 3 3 2 3 2 2 2 3 8 2 2 2 2 3 3 8 2 3 2 2 3 8 8 2 3 3 3 2 8 2 3 2 2 2 8 3 2 3 2 3 3 3 3 3 2 3 3 3 2 3 1 2 3 2 2 3 2 2 3 2 3 3
2 3 3 2 3 2 2 3 3 2 0 3 3 2 3 2 3 2 2 3 3 3 3 3 7 7 7 7 6 7 7 7 7 2 3 2 3 3 2 2 3 3 2 3 2 3 2 2 8 2 3 8 3 2 3 2 2 2 8 8 2 2 8 2 2 3 3 2 3 3 3 3 2 2 3 2 3 2 2 2 2 3 2 3 3 2 3 3 1 3 2 2 3 3 3 3 3 3 2 2
3 3 2 3 2 3 2 3 3 3 0 3 2 3 3 2 2 2 3 2 2 2 3 7 6 6 6 6 6 6 6 6 6 7 2 3 2 8 3 3 2 3 2 2 2 2 8 2 2 2 3 2 2 3 2 3 2 3 2 2 8 2 2 8 3 3 3 2 3 2 2 2 2 2 3 3 2 2 3 3 2 2 2 2 2 3 3 3 1 2 2 3 2 2 3 2 3 2 2 3
3 2 2 3 3 2 2 3 2 2 0 3 2 3 3 3 2 3 2 2 2 2 7 6 6 6 6 6 6 6 6 6 6 6 7 3 2 2 2 3 3 2 3 3 8 2 2 2 3 2 3 2 8 2 2 2 2 2 2 3 3 3 2 8 2 3 2 2 3 3 3 2 3 2 3 3 3 2 3 2 3 2 3 2 2 2 2 2 1 2 2 3 3 3 2 2 2 3 2 3
2 3 3 3 2 3 2 2 2 2 0 3 2 3 3 3 3 2 3 2 3 7 6 6 6 6 6 6 6 6 6 6 6 6 6 7 2 3 2 3 3 2 2 2 3 3 2 8 8 2 8 2 3 3 8 2 2 2 3 8 2 8 2 2 3 3 3 3 3 3 8 8 8 2 2 2 2 2 2 2 3 3 3 3 2 3 2 3 1 3 3 2 2 2 3 2 2 3 2 2
2 3 3 2 3 3 2 2 3 3 0 2 3 2 2 2 2 2 2 2 7 6 6 6 6 6 6 6 6 6 6 6 6 6 6 6 7 2 8 3 8 2 3 3 8 3 2 2 3 3 3 8 2 2 3 3 3 3 2 2 3 3 2 3 8 2 2 3 3 3 3 3 3 3 3 2 2 3 2 2 3 2 3 3 2 2 2 2 1 3 2 2 3 3 2 2 2 3 3 2
3 2 2 3 3 2 3 2 2 2 1 2 2 3 2 3 2 2 3 7 6 6 6 6 6 6 6 6 6 6 6 6 6 6 6 6 6 7 3 2 3 2 2 3 3 8 8 2 8 3 2 2 3 2 2 8 2 8 8 2 3 3 2 2 3 3 2 3 2 2 2 3 3 2 2 2 3 3 3 2 3 3 3 3 3 2 3 2 1 3 2 2 3 2 3 3 2 2 3 2
3 2 2 2 3 3 2 3 2 3 0 2 2 3 2 2 3 3 3 7 6 6 6 6 6 6 6 6 6 6 6 6 6 6 6 6 6 7 3 2 3 2 3 3 3 8 3 8 8 8 8 3 3 2 3 8 3 3 3 8 2 3 2 2 2 2 3 3 2 2 3 3 3 2 3 3 2 3 2 2 2 3 2 2 2 2 2 2 1 2 3 2 2 3 3 2 2 3 3 3
3 3 2 3 2 3 2 2 2 2 0 3 3 3 3 3 3 3 2 7 6 6 6 6 6 6 6 6 6 6 6 6 6 6 6 6 6 7 8 2 2 3 3 3 3 3 2 2 3 2 8 3 3 2 2 2 8 3 2 2 2 2 2 2 2 2 3 2 3 2 3 3 3 3 2 2 2 3 3 3 2 3 3 3 2 3 2 3 1 3 2 2 2 2 2 2 3 3 2 2
3 2 2 2 2 3 3 3 3 3 1 3 3 2 3 3 3 2 2 7 6 6 6 6 6 6 6 6 6 6 6 6 6 6 6 6 6 7 2 3 8 3 8 3 8 2 2 3 2 3 3 3 2 2 3 2 3 2 3 2 3 2 2 3 2 3 3 3 3 3 3 3 2 3 2 2 3 2 2 3 3 3 2 2 2 2 3 3 1 2 3 2 2 3 3 2 3 2 2 3
3 2 2 2 3 2 2 3 3 3 0 3 3 2 2 2 3 2 7 6 6 6 6 6 6 6 6 6 6 6 6 6 6 6 6 6 6 6 7 3 3 8 2 8 3 2 8 2 8 8 2 2 2 8 2 8 3 2 2 2 2 2 2 3 3 3 2 3 3 2 2 2 3 3 2 3 2 3 2 2 3 2 2 3 2 2 3 2 0 3 3 2 2 3 2 3 3 2 2 2
2 2 3 2 2 2 2 3 2 3 0 3 3 2 2 2 2 3 3 7 6 6 6 6 6 6 6 6 6 6 6 6 6 6 6 6 6 7 3 3 8 3 3 2 2 2 2 2 8 3 3 3 2 3 3 2 2 8 3 2 8 3 2 2 3 3 2 2 3 2 3 2 3 3 3 2 2 2 2 3 3 2 2 3 3 2 3 3 0 2 3 3 2 2 3 3 3 2 3 3
3 2 3 2 2 3 3 2 2 2 0 2 3 3 3 2 2 3 3 7 6 6 6 6 6 6 6 6 6 6 6 6 6 6 6 6 6 7 8 2 2 8 2 3 2 8 8 3 2 2 3 3 2 3 2 2 3 3 2 2 2 2 3 3 3 3 2 3 3 3 3 3 2 2 3 3 3 2 2 2 3 3 2 2 3 2 3 3 0 3 3 2 2 2 3 2 2 2 2 3
2 3 3 2 2 3 2 2 3 3 0 2 3 2 3 2 3 3 3 7 6 6 6 6 6 6 6 6 6 6 6 6 6 6 6 6 6 7 3 3 8 2 8 3 2 3 3 2 2 2 3 2 3 3 3 2 3 2 2 2 2 3 3 2 3 2 2 3 3 3 3 2 3 2 2 3 3 2 2 2 3 3 2 3 3 3 2 3 0 3 2 3 2 3 2 2 2 2 2 2
2 3 2 2 3 2 2 2 3 3 0 2 2 2 2 3 2 2 3 7 6 6 6 6 6 6 6 6 6 6 6 6 6 6 6 6 6 7 3 3 3 2 3 2 2 2 3 3 2 3 3 2 2 2 2 2 3 2 3 2 3 2 3 2 2 2 2 3 2 2 2 2 3 2 3 2 3 2 2 3 3 3 2 2 2 3 2 2 0 3 3 3 3 2 3 3 3 2 2 3
2 2 3 3 3 2 3 3 3 3 1 3 3 2 2 2 3 2 2 3 7 6 6 6 6 6 6 6 6 6 6 6 6 6 6 6 7 8 3 2 2 2 2 8 2 2 2 3 3 2 2 3 2 2 3 3 2 2 2 3 3 3 3 2 2 3 2 3 3 2 3 3 3 2 3 3 2 3 3 3 3 3 2 2 3 2 2 2 0 2 2 2 2 3 2 2 3 3 2 3
3 3 2 2 3 2 2 2 2 2 1 2 2 2 2 3 2 3 2 3 2 7 6 6 6 6 6 6 6 6 6 6 6 6 6 7 3 3 8 2 2 8 3 2 2 2 3 2 2 2 3 2 2 3 3 3 2 3 2 3 3 3 2 3 2 3 3 2 2 3 3 3 2 2 2 2 2 3 2 3 3 3 2 2 3 3 3 3 1 3 3 2 3 3 2 3 3 3 3 3
3 2 2 2 3 2 2 2 3 3 1 2 3 2 2 2 3 3 2 2 3 2 7 6 6 6 6 6 6 6 6 6 6 6 7 2 2 2 2 2 3 2 2 2 2 3 3 3 3 3 2 2 2 2 3 3 3 3 2 2 3 3 2 3 2 3 2 2 3 3 2 3 3 3 3 3 2 3 3 3 2 3 2 3 2 3 2 2 1 3 3 2 3 2 3 2 3 3 2 2
3 3 3 2 3 2 2 3 2 2 1 3 2 2 2 2 3 2 2 2 2 3 2 7 6 6 6 6 6 6 6 6 6 7 2 8 3 3 2 8 3 2 3 2 3 3 2 2 2 3 2 3 3 3 2 3 2 3 3 3 3 2 3 3 2 3 3 3 3 3 3 2 2 2 2 3 2 3 3 2 2 2 3 2 8 3 3 2 1 3 3 3 2 3 2 2 2 2 3 3
2 3 3 3 3 3 3 3 2 3 1 3 2 2 3 3 3 3 3 2 3 3 3 8 7 7 7 7 6 7 7 7 7 8 3 3 3 3 3 3 3 3 3 2 2 2 2 2 3 2 2 2 3 2 2 2 3 2 2 3 2 2 3 2 2 3 3 2 2 3 3 2 2 2 2 2 3 3 3 3 3 3 2 2 3 3 3 3 1 2 2 3 3 3 3 3 2 3 2 2
2 3 3 3 2 3 3 3 2 3 0 2 2 3 2 3 3 3 2 2 3 3 2 3 2 8 2 8 7 3 3 2 2 2 2 3 2 3 8 3 3 2 3 2 2 2 2 2 2 3 3 2 3 2 2 2 2 2 3 2 3 3 3 3 3 3 2 3 2 2 2 3 3 2 3 2 2 3 3 2 8 2 3 3 2 2 2 3 1 2 3 3 3 3 2 2 2 3 3 3
2 3 2 2 2 2 3 3 2 2 1 2 3 2 2 2 3 2 3 2 2 2 3 2 3 2 2 3 2 2 2 3 2 3 8 3 2 2 3 3 2 3 2 3 3 3 3 2 2 3 3 3 3 2 2 2 3 3 3 3 3 2 3 2 2 3 2 3 2 3 2 3 2 3 3 3 8 2 2 2 2 2 2 2 2 2 3 2 0 2 3 3 3 2 3 2 2 2 2 3
2 3 2 3 3 3 2 3 2 2 1 2 2 2 2 2 3 2 2 2 2 3 2 3 3 3 2 2 2 3 3 2 3 3 8 3 3 3 3 3 2 2 3 3 3 3 3 3 2 2 3 2 2 3 2 3 2 2 3 2 3 2 2 2 3 3 2 2 3 3 8 2 3 3 2 3 2 2 3 3 2 3 2 3 2 3 2 2 1 3 3 3 2 2 2 3 2 3 2 3
2 3 2 2 2 3 3 2 2 3 1 3 2 2 3 2 3 2 3 3 2 3 3 2 2 3 2 8 3 2 2 8 2 8 3 3 2 2 3 3 3 3 2 3 3 2 3 2 3 3 2 3 2 2 2 3 2 2 2 2 2 2 3 2 3 2 3 3 3 8 3 2 8 8 3 8 2 2 3 2 3 2 2 3 2 3 2 3 0 2 3 3 3 2 2 3 3 2 3 2
3 3 2 2 2 3 2 2 2 3 1 3 3 2 2 3 3 3 3 2 3 2 3 3 2 3 2 2 3 3 2 2 3 2 3 2 2 3 3 3 3 2 2 2 2 2 3 2 3 2 2 3 2 2 2 3 2 2 3 3 3 3 3 3 2 2 2 2 2 2 3 2 2 2 2 3 2 8 2 3 3 8 3 3 3 8 2 2 1 2 3 2 3 3 2 2 2 2 2 3
3 3 3 2 3 3 2 3 4 5 1 4 4 3 2 2 3 2 3 2 2 3 3 3 3 3 3 2 3 3 2 2 3 3 2 2 2 2 3 3 3 3 2 2 3 2 3 2 3 3 2 2 2 2 3 3 2 3 2 3 3 2 2 3 2 2 2 2 2 3 3 3 3 3 2 2 2 8 2 8 8 8 3 3 8 3 2 2 0 3 3 3 2 2 2 3 2 2 2 2
2 3 2 2 2 3 3 5 4 4 0 4 4 5 2 3 3 2 2 3 3 3 3 2 3 2 3 3 2 2 3 3 3 2 2 2 2 2 3 3 3 3 3 3 2 3 3 3 2 2 3 2 2 2 2 3 2 2 3 3 2 3 3 2 2 2 3 3 2 3 8 3 2 2 3 3 8 2 2 2 3 3 3 3 8 2 3 2 1 3 3 8 2 3 3 2 2 3 3 2
2 3 2 3 3 2 3 4 5 4 1 5 4 4 2 3 2 3 3 3 2 3 2 9 9 9 9 9 3 2 3 2 2 3 3 3 3 2 2 2 2 2 3 3 2 2 3 2 2 3 3 2 2 3 2 3 2 3 2 2 3 3 3 3 2 3 2 2 3 2 2 8 2 3 3 3 8 3 2 2 2 3 3 8 2 2 2 3 1 2 3 2 2 3 3 2 3 3 3 3
2 2 3 2 2 3 4 5 5 4 1 0 0 1 1 1 0 1 1 1 1 0 0 1 0 0 9 9 3 2 3 3 2 2 3 2 3 2 3 3 3 3 2 2 2 3 3 2 3 2 3 3 3 2 2 2 3 2 3 3 2 3 2 3 3 2 2 3 3 3 2 8 2 2 2 2 2 8 8 3 3 2 2 3 3 3 3 3 1 2 3 8 3 2 3 2 2 3 2 3
2 2 3 3 3 3 3 4 4 5 0 0 1 0 1 1 0 1 0 1 1 0 0 1 1 0 1 0 0 0 1 1 0 1 0 1 0 0 0 0 1 1 0 1 1 1 1 1 0 1 0 0 0 1 1 0 1 0 0 0 0 0 0 0 1 1 0 0 1 1 1 0 0 1 0 1 0 1 0 0 1 0 1 1 0 1 0 0 0 2 8 3 2 3 3 3 2 2 2 2
3 3 2 3 2 3 2 4 5 4 5 4 4 5 3 2 3 2 2 3 2 3 2 9 9 1 9 9 3 3 2 3 3 3 3 2 3 2 3 3 3 3 2 2 3 3 3 3 3 3 2 3 3 3 2 2 3 2 3 2 2 2 2 3 2 8 3 3 2 3 3 2 2 2 2 2 2 2 2 8 2 3 2 8 2 3 3 3 2 3 3 3 3 3 2 2 3 2 3 3
3 2 3 3 2 3 2 3 4 5 4 5 4 2 3 2 2 3 3 2 2 2 2 9 9 1 9 9 2 2 3 3 2 3 3 2 3 3 3 3 2 2 2 3 3 2 3 3 3 3 2 2 3 3 2 3 3 2 2 2 3 2 8 3 2 3 8 2 3 2 2 2 2 8 2 3 3 8 3 8 3 2 2 3 2 3 2 8 2 2 3 2 2 2 2 2 3 2 3 2
2 2 2 2 2 3 2 3 2 2 5 2 3 2 2 2 3 3 3 3 2 2 3 2 2 1 3 2 2 3 2 3 2 3 2 3 2 2 2 2 3 2 2 3 2 2 2 2 2 3 3 3 2 2 2 3 3 3 2 2 2 2 8 2 3 3 3 2 2 2 2 2 3 2 3 2 3 2 2 2 2 8 3 8 2 2 2 3 3 2 3 3 3 3 2 2 2 2 2 2
3 2 2 2 3 3 3 2 3 2 2 3 2 2 2 3 2 3 2 2 3 3 2 3 2 1 3 2 3 3 2 3 2 3 3 8 3 2 2 2 3 8 2 3 3 3 2 3 2 3 2 2 2 2 3 3 2 3 3 3 2 3 2 2 3 3 2 8 2 3 2 2 3 2 3 8 3 2 8 3 2 2 8 3 2 2 3 3 2 2 2 3 3 2 3 2 3 3 2 3
2 3 3 2 2 3 3 2 3 3 3 5 2 3 2 3 2 2 3 3 3 2 3 3 2 0 2 2 3 2 2 3 2 2 3 8 3 3 3 2 2 8 3 3 3 2 3 3 3 3 2 2 3 2 2 3 2 3 2 2 2 3 2 2 3 2 2 2 3 3 2 8 3 3 3 2 3 2 2 2 8 3 3 8 3 8 3 8 8 2 8 2 3 2 3 3 3 2 2 3
3 3 2 2 3 2 2 2 2 4 4 4 4 4 3 3 3 2 2 2 3 3 2 3 3 0 3 2 2 3 3 2 3 3 2 2 3 8 8 3 2 3 3 2 3 2 2 2 3 2 3 2 3 3 2 3 2 2 2 3 2 2 2 3 2 3 2 8 3 2 3 8 2 8 3 3 3 8 8 8 8 3 3 2 2 8 3 8 3 2 3 3 2 2 2 2 3 3 3 2
3 2 2 3 3 3 2 3 2 4 5 4 4 5 2 3 3 3 3 2 2 2 2 3 3 1 2 3 3 2 3 2 2 2 3 3 2 8 8 3 3 3 2 3 2 3 2 2 2 3 3 2 3 2 2 3 3 3 3 2 3 3 2 8 2 2 2 3 3 8 3 3 2 3 2 2 2 3 3 8 3 3 8 2 2 2 2 2 2 3 3 2 2 2 2 3 3 3 3 2
3 3 2 3 2 2 2 2 4 5 5 5 5 5 5 3 2 2 2 3 3 2 2 2 2 1 3 2 3 2 2 8 2 2 2 2 2 2 3 2 2 2 3 3 3 8 2 2 2 2 2 2 3 2 2 2 2 3 3 2 3 2 2 3 3 3 2 2 3 2 3 2 3 2 2 3 3 3 2 2 3 3 2 3 3 8 3 8 2 3 3 3 2 2 3 3 2 2 3 2
3 3 2 2 2 3 3 2 2 4 4 5 4 4 3 2 2 3 3 3 3 3 3 3 3 0 3 2 3 2 2 3 3 8 2 2 2 2 2 2 3 2 2 3 8 2 3 2 2 3 3 2 3 3 3 3 3 2 2 3 2 3 3 3 8 3 3 2 2 8 3 2 3 3 2 3 3 3 2 3 3 3 2 2 3 3 3 3 3 3 3 2 2 2 2 3 3 2 3 3
2 3 3 3 3 3 2 2 2 5 4 4 4 5 2 3 2 2 3 2 3 3 3 3 2 1 2 3 3 3 3 2 3 2 2 3 3 3 2 3 8 3 2 3 2 2 3 3 2 3 3 2 2 2 3 3 2 3 3 2 3 2 3 3 3 3 2 3 3 3 3 2 2 2 3 2 3 3 8 2 2 3 3 2 2 2 3 8 3 3 2 2 3 3 3 2 3 2 3 2
2 2 2 2 2 3 3 3 3 3 2 5 2 3 2 2 3 3 2 2 3 2 2 2 3 0 2 3 3 8 3 2 2 2 2 3 3 8 2 2 3 3 3 8 3 2 2 2 2 2 3 3 3 3 2 3 3 2 3 3 3 2 3 2 3 3 3 8 2 2 2 2 3 3 3 3 2 2 3 3 2 3 3 3 2 2 3 2 2 3 3 3 2 3 2 3 3 3 3 3
2 2 3 2 3 3 3 3 2 2 2 3 2 2 3 2 3 3 2 2 2 2 2 3 3 1 3 2 3 8 3 3 2 8 3 3 2 3 3 2 2 2 2 2 3 2 3 2 2 3 3 3 2 2 3 2 2 2 3 3 3 2 2 2 2 3 3 3 3 2 3 2 8 3 8 3 2 3 2 2 3 3 2 3 2 3 3 2 2 3 2 3 3 2 3 3 3 2 2 2
2 3 2 3 3 2 2 3 3 3 3 3 2 2 2 3 2 3 3 3 2 2 3 3 2 1 2 3 2 2 3 3 3 3 3 8 3 8 3 2 3 3 2 3 2 2 2 8 2 2 2 3 3 2 3 3 2 3 2 3 3 3 3 3 2 2 2 3 2 2 3 2 2 3 2 2 2 3 2 2 3 8 8 2 3 2 3 3 2 3 2 2 2 3 3 3 3 2 3 2
3 3 2 2 2 3 3 2 2 3 2 3 3 2 2 3 2 2 2 2 3 3 3 2 2 1 3 3 3 2 3 2 3 8 3 3 3 3 3 3 2 3 3 2 3 3 2 8 3 3 2 2 3 2 3 3 3 2 3 3 2 2 3 2 3 3 2 2 2 8 3 3 2 8 3 3 3 2 2 2 3 2 2 3 2 2 3 3 3 3 3 3 3 2 2 2 2 3 2 3
2 2 3 2 2 2 3 3 3 3 3 3 3 3 2 2 2 2 2 2 2 2 2 2 3 0 2 3 2 2 3 3 2 3 3 2 2 2 2 3 3 8 2 3 2 2 3 3 2 3 2 2 3 3 3 3 2 3 5 3 3 2 2 2 3 3 2 3 3 3 2 3 3 3 3 2 2 3 2 3 3 3 2 2 3 3 2 3 3 3 3 3 2 2 3 2 3 2 2 2
2 3 2 3 3 3 2 2 2 2 3 3 3 2 2 2 2 3 3 2 2 2 2 3 3 1 3 2 3 2 2 2 3 3 2 8 2 2 2 2 2 2 3 2 8 3 3 2 2 3 3 2 2 2 3 3 4 4 5 5 4 2 2 3 3 3 3 2 2 3 2 2 3 3 3 3 3 8 3 2 2 2 2 3 3 3 2 3 2 3 2 2 2 3 3 3 3 3 3 2
3 2 3 3 2 3 3 3 2 3 2 2 3 3 2 3 2 2 3 3 2 2 2 3 2 0 3 2 2 3 3 8 2 2 2 8 8 2 3 3 2 2 3 3 3 2 3 2 2 3 2 3 3 2 2 3 5 5 5 4 4 2 3 2 3 2 3 3 3 3 3 3 3 3 3 2 2 8 3 3 2 2 2 3 3 2 2 3 2 3 2 2 3 3 2 2 2 3 3 3
3 3 3 2 2 2 3 2 3 3 2 2 3 2 2 3 2 2 3 3 3 3 3 3 3 0 2 3 3 3 2 3 2 3 3 2 3 8 2 8 3 7 2 2 8 2 8 2 2 2 3 2 2 2 2 5 5 4 1 5 4 5 2 3 2 3 3 2 3 2 8 3 3 2 2 2 2 3 2 2 3 2 8 3 3 2 2 3 2 2 2 3 3 2 3 2 3 3 3 3
2 2 2 2 2 3 3 2 3 2 3 3 3 2 3 2 3 2 2 3 2 2 2 3 3 0 2 2 2 3 2 8 3 3 2 2 3 3 7 7 7 6 7 7 7 8 2 3 2 2 2 3 2 3 2 2 5 4 1 4 4 3 3 3 2 3 3 2 3 3 2 2 8 3 2 2 8 3 3 3 2 2 2 3 2 3 3 3 3 2 2 2 3 3 2 3 2 2 2 3
3 2 2 3 2 2 3 3 2 3 3 2 2 2 3 2 3 3 2 2 2 2 2 2 2 1 2 3 2 2 3 3 2 3 2 3 3 7 6 6 6 6 6 6 6 7 3 3 3 3 2 5 2 3 2 2 4 5 0 4 4 2 3 3 2 2 2 3 3 2 3 3 2 2 3 2 3 2 3 2 2 3 2 3 2 2 2 2 3 3 2 2 2 3 2 3 3 2 2 2
2 3 3 3 2 3 2 2 3 3 3 3 2 3 2 3 3 2 2 2 2 2 2 2 3 1 3 3 3 2 2 2 2 2 2 3 7 6 6 6 6 6 6 6 6 6 7 2 4 5 5 4 5 4 5 2 2 3 1 3 3 3 3 3 3 3 2 2 3 2 3 2 2 2 2 3 2 2 3 3 3 2 3 2 2 3 2 2 3 2 2 2 3 3 2 3 2 2 2 2
3 2 2 3 2 3 2 2 2 2 2 3 2 2 2 3 2 3 2 3 3 2 3 3 2 0 2 2 2 2 2 2 3 3 3 3 7 6 6 6 6 6 6 6 6 6 7 5 5 5 5 4 5 4 5 4 2 3 1 3 3 3 3 3 2 2 2 2 3 2 3 2 3 3 3 2 3 3 2 2 2 3 3 3 2 2 3 3 3 3 3 3 3 3 3 3 3 3 2 2
3 2 3 2 3 2 3 2 3 2 2 2 2 3 8 2 3 2 3 3 3 3 2 2 3 0 3 3 3 3 3 2 3 2 3 2 7 6 6 6 6 6 6 6 6 6 7 5 5 5 5 5 5 4 4 4 2 3 0 3 2 3 3 3 3 3 2 2 2 2 3 3 3 2 3 2 3 2 3 2 3 3 3 2 2 2 2 2 3 2 2 2 2 3 3 2 2 3 2 3
2 3 2 2 3 3 3 2 8 2 3 3 2 3 2 2 2 3 3 3 2 3 2 3 3 0 2 2 3 2 3 2 3 3 3 7 6 6 6 6 6 6 6 6 6 6 6 4 5 4 5 4 4 4 5 5 3 3 0 2 3 3 2 3 2 2 3 3 3 2 3 2 2 3 2 2 3 3 3 3 2 3 2 2 3 2 2 3 3 3 3 2 2 2 3 2 3 3 2 2
2 2 2 3 2 3 2 2 2 3 2 3 3 2 2 2 2 3 2 2 3 3 3 2 2 1 3 2 2 3 2 2 2 2 3 2 7 6 6 6 6 6 6 6 6 6 4 5 4 5 4 5 4 4 4 5 4 3 1 2 2 3 3 2 3 2 3 2 2 3 3 2 2 2 3 3 3 2 2 3 2 3 3 2 3 2 3 3 2 3 2 3 3 2 2 2 2 2 3 2
3 2 2 2 2 3 3 3 2 2 3 2 2 2 3 8 2 8 8 2 3 3 2 2 3 1 2 2 2 2 2 3 3 2 3 2 7 6 6 6 6 6 6 6 6 6 7 4 5 4 4 5 4 4 4 5 2 2 0 3 3 2 3 3 2 3 3 3 2 3 3 3 3 2 3 2 3 3 2 3 2 2 3 3 3 3 3 3 3 3 2 3 2 3 2 2 2 2 2 3
3 3 3 3 3 3 8 3 8 3 2 2 8 2 8 3 3 8 3 3 2 3 3 2 2 0 2 3 2 2 3 3 2 3 2 2 7 6 6 6 6 6 6 6 6 6 7 4 4 5 4 4 5 4 5 4 2 3 1 2 2 3 2 2 2 3 3 3 3 2 2 3 2 2 2 3 2 2 3 2 2 2 2 2 2 3 3 3 2 2 2 3 2 3 2 3 2 3 2 2
3 3 2 2 2 8 2 2 2 2 2 3 3 3 3 3 3 3 3 8 3 2 3 3 3 1 3 3 2 2 3 3 2 2 2 3 2 7 6 6 6 6 6 6 6 7 2 5 5 4 4 4 4 5 5 5 2 3 0 2 2 2 2 3 2 3 3 2 3 2 3 2 2 2 2 2 2 3 2 2 3 3 3 2 3 3 2 2 3 2 3 2 2 3 3 3 3 2 2 3
2 3 2 2 8 3 2 2 3 2 3 3 2 3 2 2 3 3 3 3 2 2 2 3 2 1 3 2 3 2 3 3 2 3 2 2 3 3 7 7 7 6 7 7 7 2 3 2 4 5 5 4 5 5 5 2 2 3 1 9 9 9 9 9 2 3 3 2 3 2 2 3 2 3 3 2 2 3 3 3 2 2 2 2 2 3 2 2 3 3 2 2 2 3 3 2 2 2 3 3
2 3 2 2 2 2 8 3 3 2 3 2 3 3 3 3 3 2 2 2 2 2 3 2 2 0 3 2 2 3 3 3 3 2 2 3 2 2 3 2 3 7 2 2 2 2 2 8 8 3 3 5 2 2 2 2 2 3 1 9 9 9 9 9 3 2 2 3 2 3 3 2 3 3 3 2 2 2 2 2 2 2 3 2 2 2 3 3 2 3 2 3 3 3 2 3 3 2 3 3
2 2 2 3 2 3 2 8 2 3 3 3 2 8 2 3 2 2 3 2 3 2 8 3 3 1 0 1 1 0 1 0 1 1 0 0 0 1 1 1 1 1 0 1 1 0 1 0 0 0 0 1 1 0 1 1 1 0 0 0 0 0 9 9 2 3 3 3 3 3 3 2 3 2 3 3 3 2 2 2 2 2 2 2 2 3 3 2 3 2 3 3 2 3 2 2 2 3 3 2
2 3 2 2 2 2 3 2 3 2 3 3 3 2 3 8 3 2 2 3 3 3 3 3 2 2 3 2 3 2 3 3 2 3 2 3 3 3 3 2 2 3 2 3 3 8 2 3 3 2 2 2 3 8 3 2 2 3 2 9 9 9 9 9 3 2 3 2 3 3 2 2 3 3 2 3 2 2 2 3 2 2 3 3 3 2 2 2 3 3 2 3 3 3 2 3 3 3 2 2
2 2 2 2 3 2 2 2 3 3 2 3 3 3 3 3 2 3 2 2 2 2 3 2 3 2 3 2 8 2 2 2 2 2 2 2 3 2 3 2 2 3 2 2 2 2 3 3 3 2 2 8 8 3 2 3 2 3 2 9 9 9 9 9 2 3 2 2 2 2 2 3 2 3 3 3 2 3 2 3 3 3 3 3 2 2 2 2 3 3 3 3 2 3 2 3 2 2 2 2
2 2 2 3 2 2 3 3 3 2 2 2 2 2 3 3 3 3 3 8 3 2 3 3 2 2 3 2 3 2 2 2 3 3 2 2 3 3 3 3 3 2 2 2 2 2 2 3 3 3 2 3 3 8 2 2 2 2 3 2 2 3 2 3 2 2 2 2 2 3 3 3 2 3 2 3 3 3 2 2 3 2 3 2 3 2 2 3 3 2 3 2 3 3 2 3 2 3 2 3
3 2 3 2 3 2 3 2 2 2 3 8 3 2 3 2 2 3 2 2 2 8 3 2 3 8 2 2 2 2 3 3 2 2 2 2 2 2 2 3 2 2 2 2 3 2 8 2 3 3 2 3 3 3 2 2 2 3 2 2 2 2 3 2 3 2 2 2 2 2 3 3 2 3 3 2 3 2 3 2 2 2 2 3 3 2 3 2 3 2 2 2 2 3 3 2 3 2 3 3
3 2 3 3 3 3 2 2 2 2 3 2 3 3 3 2 2 3 8 2 2 3 8 2 3 3 3 3 3 3 3 3 2 2 3 3 3 3 2 3 8 3 2 2 2 3 8 2 8 3 8 2 2 2 3 3 2 3 3 2 3 2 2 2 2 2 2 2 3 2 3 3 2 2 2 3 2 2 2 3 2 2 2 2 2 3 2 2 3 2 3 3 3 3 3 2 3 2 2 2
2 2 2 2 8 3 3 3 3 2 8 2 3 2 3 2 2 3 2 2 3 2 2 3 3 3 3 3 2 2 3 3 2 3 2 2 2 3 3 2 8 3 2 2 2 2 2 8 2 2 2 2 3 2 8 3 2 2 3 2 3 2 3 3 3 2 3 3 3 2 2 3 3 2 2 2 3 3 2 3 2 2 3 2 2 2 2 2 2 3 3 2 3 3 3 3 2 3 2 2
2 2 3 2 8 2 3 2 8 2 3 3 2 3 2 2 3 3 3 2 2 2 3 3 3 3 3 2 8 3 2 3 3 3 3 2 3 3 3 3 2 3 8 3 2 2 8 2 2 2 3 3 2 3 2 2 3 3 2 3 3 3 3 2 2 2 2 3 3 2 3 3 2 3 3 3 2 3 2 3 3 2 2 3 2 2 3 2 3 2 3 3 3 2 2 2 2 3 3 3
2 2 2 2 3 3 2 3 3 3 2 3 2 2 2 3 3 3 2 2 3 3 3 3 2 3 8 3 2 2 2 2 3 3 2 2 3 2 3 3 2 3 3 2 3 2 3 2 2 2 2 3 2 8 2 3 2 2 2 3 3 2 3 3 2 3 3 3 3 3 3 3 3 2 2 3 3 3 2 2 3 3 3 3 3 2 2 2 2 2 3 2 3 2 3 2 3 3 2 2
3 3 2 2 3 2 8 3 3 3 2 3 2 3 3 3 3 3 2 2 3 2 8 2 2 3 3 3 2 3 2 3 2 3 2 3 2 3 2 3 8 2 8 2 2 2 8 8 3 2 3 2 2 2 2 3 2 2 2 2 3 2 2 3 3 2 2 2 3 2 2 3 3 2 3 2 2 2 2 2 3 2 2 2 3 3 2 2 2 3 3 2 3 2 3 2 3 2 3 2
2 3 3 3 3 2 2 3 2 8 2 2 3 3 3 2 2 3 2 2 2 8 2 2 8 2 2 2 3 2 2 2 2 3 3 3 2 2 3 3 3 3 3 3 8 3 2 8 3 8 2 8 2 2 3 3 3 3 3 3 2 3 3 2 3 3 2 3 2 2 3 3 3 3 3 2 2 2 3 3 2 3 2 2 2 3 3 2 3 2 2 3 2 3 2 3 3 2 2 3
3 2 2 2 8 2 3 3 3 3 2 2 2 3 8 2 3 3 2 2 3 2 3 3 2 2 3 2 2 3 3 2 3 2 2 3 2 2 3 2 3 3 3 3 3 8 2 3 3 2 3 3 3 8 2 3 2 2 2 2 2 2 2 3 3 2 2 2 2 3 2 2 3 2 2 2 3 2 3 3 3 3 2 2 3 2 2 3 2 3 3 2 2 3 3 3 3 3 2 2
3 3 2 3 2 2 2 2 8 2 2 2 2 3 3 8 3 2 3 2 3 3 3 2 8 2 8 3 3 3 2 3 2 2 3 3 2 3 2 2 3 2 2 2 2 3 2 3 2 3 3 3 3 2 2 3 3 2 2 3 3 3 2 3 3 3 2 2 3 3 2 3 2 3 2 3 3 3 2 2 2 2 2 2 2 2 3 2 2 2 3 2 3 3 3 2 2 3 3 2
2 2 3 3 8 2 2 2 3 3 2 2 3 2 2 2 3 3 8 2 3 3 3 2 2 8 2 2 2 3 3 2 3 2 3 2 2 2 3 2 2 2 2 2 3 3 8 8 3 3 3 3 3 3 2 3 3 3 3 2 3 2 2 3 2 2 3 3 2 2 3 3 2 2 2 3 2 3 3 2 3 3 3 3 3 3 3 2 2 3 2 3 3 3 3 2 2 3 2 3
2 3 2 3 3 3 2 3 2 3 2 2 3 2 2 3 3 2 3 3 2 2 3 2 8 8 2 2 3 2 2 3 2 3 2 2 3 3 2 3 3 3 2 3 3 3 2 3 3 2 2 3 2 3 2 3 3 2 3 3 2 3 3 2 2 3 3 3 3 3 3 3 3 3 3 2 2 3 2 2 3 2 3 2 3 2 3 2 3 2 3 3 2 2 2 3 2 3 2 3
3 3 2 2 2 2 2 3 8 2 2 3 3 2 3 2 8 2 2 2 8 2 2 2 2 3 2 3 3 2 2 3 3 3 2 2 3 3 2 3 2 2 2 2 2 2 2 3 3 3 3 2 3 3 3 3 3 2 3 3 3 2 2 3 3 2 3 2 3 2 3 2 3 2 3 3 3 2 2 3 2 3 3 2 2 2 3 3 3 2 3 3 3 2 3 3 3 2 3 2
3 3 3 2 2 2 2 2 2 2 3 3 3 2 2 2 2 3 3 2 8 3 2 2 2 3 3 2 2 3 2 3 3 2 2 2 3 3 3 3 2 2 2 3 2 2 2 2 2 2 2 2 3 3 2 3 2 3 2 2 3 3 3 2 2 3 3 3 2 2 2 3 2 2 3 2 2 3 2 2 3 3 3 3 2 2 3 2 2 3 3 2 2 3 3 2 2 3 3 3
