4 4 4 4 4 4 4 4 4 4 4 4 4 4 4 4 4 4 4 4 4 4 4 4 4 4 4 4 4 4 4 4 4 4 4 4 4 4 4 4 4 4 4 4 4 4 4 4 4 4 4 4 4 4 4 4 4 4 4 4 4 4 4 4 4 4 4 4 4 4 4 4 4 4 4 4 4 4 4 4 4 4 4 4 4 4 4 4 4 4 4 4 4 4 4 4 4 4 4 4
4 3 8 8 2 8 3 3 8 8 3 8 8 8 8 3 8 8 3 8 8 8 3 8 8 8 8 2 8 2 8 2 8 8 8 8 3 8 3 8 3 8 8 3 2 8 8 8 8 8 2 2 8 8 8 8 2 8 3 2 8 3 2 8 2 8 3 2 3 3 3 2 8 3 3 3 3 3 3 2 2 3 3 2 2 3 2 3 2 2 2 8 3 3 3 2 2 2 3 4
4 2 3 2 8 8 8 8 8 8 8 8 8 8 8 8 8 8 3 2 2 2 8 8 8 8 8 3 8 8 8 8 3 8 8 2 3 8 8 3 8 2 8 8 8 8 8 8 3 8 8 8 2 8 8 8 8 8 8 8 8 8 3 8 8 2 3 2 3 2 2 8 2 3 2 3 2 2 8 2 3 3 3 8 3 3 3 2 3 2 3 2 3 2 3 3 2 2 8 4
4 3 8 3 2 8 8 8 8 8 8 8 8 8 8 8 8 8 2 8 8 2 8 3 8 8 2 8 8 8 8 8 8 8 8 8 3 8 8 8 8 8 8 3 8 3 3 8 8 8 8 3 8 3 8 8 8 8 8 2 8 2 8 3 3 3 3 3 2 3 3 3 2 3 3 3 2 3 2 2 3 2 2 3 3 3 3 3 2 2 3 3 3 3 2 3 3 8 8 4
4 8 3 2 8 8 8 3 3 8 8 8 8 8 8 3 8 8 8 2 8 8 8 8 8 2 2 8 8 3 2 8 2 8 8 8 8 8 8 8 3 2 8 8 8 2 3 8 8 8 8 8 2 3 8 3 8 8 8 8 8 2 8 3 2 3 2 2 2 3 8 2 2 2 2 3 8 3 3 2 2 2 3 2 2 2 2 2 3 3 3 8 3 3 2 3 2 3 3 4
4 8 3 8 8 8 8 8 8 8 8 8 8 8 8 2 8 2 3 3 2 8 2 8 3 8 8 3 8 8 2 8 8 2 8 2 2 8 8 2 8 2 8 2 8 8 8 8 8 8 8 2 3 8 8 8 8 8 8 3 8 8 8 8 2 2 2 3 3 2 3 2 3 3 3 3 2 2 2 2 3 3 3 2 2 2 3 2 3 3 2 2 3 3 2 3 3 3 3 4
4 2 8 2 2 8 3 8 3 2 3 3 8 8 8 8 2 8 8 8 8 8 8 8 8 3 8 8 8 8 3 8 3 2 8 3 8 3 8 2 3 3 8 2 8 8 8 8 8 8 3 8 2 8 8 8 8 8 8 8 8 8 2 8 2 2 3 2 3 2 2 3 8 2 2 3 3 3 3 8 3 2 2 3 8 3 3 2 2 2 2 2 2 3 3 2 2 3 3 4
4 8 8 2 8 3 3 8 8 8 3 8 3 8 3 3 8 8 8 2 8 8 8 8 2 8 8 8 8 2 3 2 3 8 8 8 8 8 8 8 2 2 8 3 8 8 8 3 8 8 3 2 8 8 8 8 8 8 8 8 3 2 8 3 2 3 3 3 2 3 2 2 3 8 3 2 2 3 3 2 3 2 3 3 3 2 3 3 3 3 3 2 2 2 2 2 2 2 3 4
4 8 8 8 2 8 8 2 2 3 3 3 2 8 8 8 8 8 3 3 8 8 8 8 8 8 8 8 8 3 8 2 8 3 8 8 2 8 8 2 8 2 8 2 8 2 3 3 8 8 8 3 2 2 3 8 8 8 8 8 3 2 3 8 3 3 2 2 3 3 2 3 3 3 3 2 2 2 2 2 3 2 2 3 3 3 3 3 2 2 3 3 3 3 2 3 2 3 3 4
4 8 8 8 8 8 8 3 3 3 3 3 2 8 2 3 3 8 8 3 8 8 8 3 8 8 8 8 8 8 8 8 2 8 8 3 8 8 8 8 8 8 3 8 3 8 8 8 8 2 8 3 8 8 2 2 8 2 2 3 3 3 3 3 2 3 3 2 2 3 2 3 2 2 2 3 3 3 2 2 2 2 3 3 2 3 2 3 2 3 2 3 2 2 3 2 3 2 2 4
4 8 2 8 8 8 8 8 3 3 1 1 0 2 8 3 8 8 3 2 8 8 8 8 8 8 8 2 8 2 8 8 3 8 8 3 8 3 8 2 8 8 8 8 8 2 8 2 2 8 8 8 8 8 8 8 8 8 8 2 2 3 2 2 2 3 2 2 3 2 2 8 3 3 2 2 3 2 2 2 2 3 2 2 2 3 2 3 2 3 3 2 2 2 3 3 2 2 2 4
4 2 8 8 2 3 3 8 2 3 2 3 1 8 8 3 2 8 8 8 8 8 2 8 8 3 8 3 2 8 8 8 2 8 8 8 8 2 8 8 8 8 8 8 8 8 8 2 8 8 8 8 8 8 8 3 8 3 3 3 3 3 2 3 2 8 3 3 2 2 3 3 2 2 2 3 3 8 2 3 2 2 3 3 3 2 3 3 8 3 2 2 2 2 3 3 3 3 2 4
4 8 3 8 8 3 8 3 3 2 3 2 1 8 3 2 2 8 8 8 2 2 3 8 8 3 8 2 8 8 8 3 2 8 8 8 8 8 8 3 8 8 8 8 8 8 8 3 8 8 2 8 8 8 2 8 8 3 3 3 3 3 3 2 2 2 3 3 3 3 3 3 3 2 3 2 3 2 2 3 2 2 2 2 3 3 2 8 2 2 3 2 3 2 3 2 2 3 2 4
4 8 8 8 8 2 8 8 8 8 8 8 0 3 8 8 8 8 8 8 8 8 8 8 3 8 8 2 3 8 8 2 2 2 8 3 8 8 2 2 8 3 3 8 8 2 8 8 8 8 3 2 2 8 3 8 2 8 3 2 3 2 3 3 3 2 2 3 2 3 3 2 3 3 3 3 2 2 2 2 3 2 2 2 3 3 2 2 2 3 3 3 2 2 2 3 2 8 8 4
4 3 2 3 8 8 8 2 8 8 8 3 1 2 8 3 2 8 2 3 8 3 3 2 2 8 8 2 8 3 8 8 8 8 2 3 8 8 3 8 8 8 8 8 8 8 8 8 8 3 3 8 8 8 3 8 3 2 3 2 3 2 2 8 3 2 3 2 2 3 3 3 2 2 2 2 2 2 2 2 3 2 8 3 3 3 2 3 2 8 3 2 3 2 2 3 3 2 3 4
4 8 2 8 8 8 2 8 3 8 3 8 0 8 8 2 8 8 8 8 2 8 8 8 3 8 8 8 8 8 2 8 8 8 8 8 3 8 8 8 3 8 8 8 8 8 8 2 8 3 8 8 8 8 8 2 2 3 2 2 2 2 3 2 3 2 2 2 8 3 2 2 2 2 3 3 2 2 3 3 2 3 3 2 2 3 3 3 3 8 2 3 2 2 2 2 2 2 3 4
4 8 2 3 8 8 8 3 8 8 8 2 1 8 8 8 8 8 8 8 2 8 3 2 8 8 8 8 8 8 8 3 8 8 8 8 3 2 3 2 8 8 8 8 8 8 3 8 8 3 8 2 8 2 3 2 2 2 3 2 3 3 2 2 2 3 2 2 2 3 2 3 3 2 2 2 2 2 3 2 2 3 2 2 3 2 3 3 2 3 3 3 8 3 3 2 2 2 3 4
4 3 2 8 2 3 2 8 2 8 2 8 0 8 3 8 8 3 8 8 3 8 8 2 8 8 2 8 8 8 8 2 8 8 8 8 8 8 3 8 3 8 8 3 3 8 2 8 8 8 8 8 8 3 3 2 2 2 3 3 3 3 2 2 2 3 3 3 3 3 3 2 8 2 2 3 9 9 9 9 9 2 3 2 2 2 3 3 3 3 3 2 3 2 3 2 3 3 3 4
4 3 8 2 8 8 3 2 8 8 8 8 0 8 8 8 8 2 2 8 2 3 8 8 3 8 3 8 8 8 3 8 8 8 3 2 8 3 8 8 8 8 3 8 8 8 3 2 2 8 8 8 3 2 8 3 3 2 3 2 3 2 2 3 3 3 2 2 3 3 3 3 3 3 3 2 9 9 9 9 9 3 3 3 8 2 2 3 3 2 2 8 3 3 2 3 2 2 2 4
4 2 8 8 8 8 8 8 8 2 8 8 1 3 8 8 8 2 8 8 2 3 8 8 8 8 8 8 8 8 8 8 2 2 8 3 3 3 8 8 8 8 8 3 8 8 8 8 8 8 3 3 3 3 3 2 2 3 2 2 8 3 3 2 3 3 3 2 2 3 2 3 2 3 3 2 9 9 0 9 9 3 3 8 8 2 2 3 3 2 3 2 3 3 8 3 3 3 3 4
4 2 8 8 3 3 8 8 8 3 8 8 1 3 8 3 8 2 3 8 2 8 2 8 8 8 8 3 3 8 8 3 3 8 2 3 3 8 2 8 8 2 8 3 2 2 8 8 8 3 2 3 3 2 2 2 2 2 3 2 3 2 2 2 3 2 8 2 3 3 2 2 3 3 3 2 9 9 0 9 9 2 2 8 2 3 2 3 2 3 3 2 2 3 3 2 3 2 3 4
4 8 8 3 8 8 8 3 3 8 8 8 0 8 8 8 8 8 8 8 3 3 8 8 8 8 8 8 8 2 3 8 8 3 2 8 8 8 8 2 8 8 8 8 3 8 8 8 2 8 3 3 8 2 3 3 8 2 2 3 2 3 2 3 2 3 3 2 2 2 3 2 3 3 3 2 9 9 0 9 9 3 3 3 3 2 3 2 2 2 2 3 8 3 2 2 3 2 2 4
4 3 8 8 3 8 8 8 8 8 8 8 0 8 3 8 8 3 8 2 8 8 8 8 8 2 2 2 8 8 3 2 8 8 2 8 2 8 8 8 3 3 8 3 8 2 3 2 3 3 3 3 2 8 2 3 2 2 2 3 3 3 3 2 3 3 3 3 3 2 3 2 2 2 2 3 3 2 1 3 3 3 2 3 3 2 2 2 2 2 3 3 2 3 3 2 2 3 3 4
4 8 2 3 8 3 8 8 8 8 3 2 1 8 8 2 8 8 8 8 8 8 8 8 8 8 2 3 8 8 8 8 8 8 2 8 8 8 8 8 2 3 8 8 8 8 2 2 2 3 3 8 2 3 3 3 3 2 3 2 3 2 3 3 3 3 3 3 2 3 3 3 2 2 2 2 2 3 1 3 3 3 2 2 2 2 2 3 2 2 2 3 2 2 3 3 2 3 2 4
4 2 8 8 8 2 8 3 8 3 8 2 0 2 8 8 8 2 3 2 8 8 8 3 8 2 8 8 8 8 8 3 8 8 8 8 8 8 8 8 8 3 8 8 3 2 3 2 8 3 3 3 2 3 2 3 2 2 2 2 8 3 2 2 3 2 3 2 3 2 3 3 2 2 3 3 3 3 1 2 3 2 3 2 2 2 2 3 2 2 2 3 2 3 2 8 2 3 2 4
4 8 8 8 3 8 3 8 8 2 8 8 1 8 8 8 8 8 8 8 2 8 8 8 8 8 8 8 8 8 8 8 8 3 3 3 8 8 8 8 2 8 8 3 3 3 2 3 2 2 3 2 8 3 2 3 3 2 3 3 2 3 2 3 2 3 8 3 3 3 3 2 3 3 3 3 2 3 0 2 2 2 3 3 2 2 3 8 3 3 3 3 3 3 2 2 2 2 2 4
4 8 8 8 8 8 2 8 8 8 3 8 0 8 8 3 8 2 8 8 8 8 8 3 8 2 8 3 8 8 8 8 8 8 8 8 8 8 8 3 8 2 2 3 3 2 2 2 3 3 2 2 8 3 2 3 2 2 2 3 3 2 2 3 3 2 2 2 2 2 2 8 3 3 3 3 2 3 1 3 2 2 2 2 3 2 3 2 8 3 2 3 3 3 8 2 3 3 2 4
4 3 8 8 8 3 8 8 8 8 2 2 1 8 8 8 3 8 2 8 2 8 8 8 8 8 8 8 8 2 8 3 8 3 8 8 8 8 3 8 2 3 2 2 2 2 3 3 2 3 2 3 2 3 3 3 3 2 7 8 3 3 2 2 2 3 8 3 2 3 2 2 3 2 3 2 8 2 1 2 3 2 2 3 3 2 3 3 2 3 2 2 8 3 2 3 2 2 3 4
4 8 8 3 3 8 8 8 8 8 2 8 1 8 8 8 8 8 3 8 8 8 2 8 8 8 8 2 8 8 8 8 8 8 8 8 8 2 2 2 3 3 3 3 3 2 3 3 3 2 3 2 3 2 3 7 7 7 6 7 7 7 2 2 2 2 2 2 2 2 3 3 8 3 3 3 8 3 1 3 2 2 3 2 2 3 3 2 3 2 3 2 3 2 3 2 3 3 2 4
4 8 3 8 2 8 8 2 2 2 8 8 1 8 8 8 8 3 8 8 3 2 8 8 8 8 8 2 8 2 8 8 8 8 8 8 8 8 2 2 3 3 2 2 3 2 3 3 3 2 3 3 3 2 7 6 6 6 6 6 6 6 7 3 2 2 3 3 2 3 2 2 3 3 3 3 2 3 0 3 3 3 8 2 2 2 8 8 3 2 3 3 2 3 2 3 2 3 2 4
4 8 8 8 2 8 8 8 3 8 2 8 0 2 3 2 3 2 8 8 8 8 3 8 8 8 8 8 8 8 8 8 8 3 8 8 8 3 8 8 3 2 3 3 3 2 2 2 3 2 3 3 2 7 6 6 6 6 6 6 6 6 6 7 3 3 2 3 2 8 2 2 2 3 3 2 3 2 1 8 3 3 2 2 2 3 2 3 2 3 2 3 3 2 3 3 3 3 3 4
4 3 3 3 2 8 8 8 3 2 8 8 1 3 8 3 8 8 2 8 3 3 8 8 8 3 3 3 3 8 8 8 8 8 8 2 2 3 2 2 3 3 3 3 2 2 2 3 2 3 2 3 7 6 6 6 6 6 6 6 6 6 6 6 7 3 2 3 2 3 2 2 2 3 2 3 2 3 1 2 3 3 3 3 2 3 2 3 2 2 3 2 3 2 2 3 2 2 3 4
4 8 8 8 8 8 3 8 8 3 8 8 0 8 8 8 8 8 3 8 2 3 8 2 2 8 8 8 8 8 8 8 2 8 2 3 2 2 3 2 2 2 2 2 2 3 3 3 2 3 3 7 6 6 6 6 6 6 6 6 6 6 6 6 6 7 2 2 2 3 2 8 2 2 2 2 3 3 1 3 2 3 2 2 3 8 3 3 2 3 2 2 3 3 2 2 2 3 2 4
4 8 8 8 3 8 8 8 2 8 3 8 1 2 3 8 8 8 8 8 8 8 8 8 8 8 8 8 8 2 8 8 8 2 3 3 2 3 2 3 3 3 2 3 2 3 3 3 2 8 3 7 6 6 6 6 6 6 6 6 6 6 6 6 6 7 2 2 2 3 3 3 2 3 3 3 2 3 1 2 2 3 2 8 2 3 3 3 2 3 2 3 3 3 2 2 2 3 3 4
4 8 8 8 3 2 2 2 8 8 8 8 0 8 8 2 2 8 8 2 8 8 8 3 3 8 3 8 2 8 3 8 2 3 3 2 3 2 3 2 3 3 3 3 3 2 2 8 2 8 2 7 6 6 6 6 6 6 6 6 6 6 6 6 6 7 2 2 3 2 3 3 3 2 3 2 3 8 1 3 3 2 2 2 2 3 2 2 8 3 3 2 3 2 2 3 2 3 3 4
4 8 8 8 2 8 2 8 8 8 2 8 0 8 2 8 8 8 8 8 8 8 8 8 8 8 8 8 3 8 2 2 2 3 2 3 3 2 2 3 8 3 3 3 2 2 3 8 2 2 7 6 6 6 6 6 6 6 6 6 6 6 6 6 6 6 7 2 3 2 2 3 3 3 3 3 2 2 1 2 3 2 2 2 2 3 2 2 2 2 8 3 3 3 2 2 8 3 2 4
4 3 2 3 3 2 3 2 3 3 2 3 0 3 8 2 2 2 3 2 2 2 8 3 2 2 2 3 2 2 2 2 8 8 2 2 2 3 3 8 3 3 3 2 2 2 3 2 3 3 2 7 6 6 6 6 6 6 6 6 6 6 6 6 6 7 2 2 3 2 2 3 3 3 2 2 3 2 0 3 3 3 3 3 2 8 2 2 3 3 3 2 8 2 3 2 2 3 3 4
4 3 2 3 3 3 2 2 3 2 2 3 1 2 3 2 3 2 2 2 3 3 3 2 3 2 3 3 3 3 3 3 3 2 2 2 3 2 2 3 3 3 3 8 2 2 2 3 2 2 2 7 6 6 6 6 6 6 6 6 6 6 6 6 6 7 2 2 3 3 3 2 2 3 3 2 3 2 1 3 3 3 3 3 3 2 2 2 3 3 2 2 3 2 3 3 2 2 2 4
4 8 2 2 2 3 2 2 2 3 2 3 0 3 3 3 2 3 3 2 3 3 2 3 3 2 2 3 3 8 3 2 3 3 2 2 2 3 3 3 2 2 2 2 2 3 8 2 3 2 2 7 6 6 6 6 6 6 6 6 6 6 6 6 6 7 2 3 2 3 2 2 8 3 2 2 2 8 0 2 3 2 2 3 2 2 2 3 3 3 3 2 2 2 3 2 2 3 3 4
4 2 2 3 8 2 3 2 2 3 2 2 1 2 2 2 2 2 2 3 3 3 2 3 2 2 2 2 3 2 2 3 2 3 2 2 2 3 2 3 3 3 2 2 2 2 2 3 2 3 2 2 7 6 6 6 6 6 6 6 6 6 6 6 7 3 2 2 2 2 2 3 2 3 3 2 3 3 0 2 3 3 2 2 2 3 2 2 3 3 2 2 2 2 2 2 2 3 3 4
4 3 2 2 3 3 3 2 8 3 8 2 0 2 3 2 2 2 2 2 8 8 2 3 2 3 3 2 3 3 3 3 2 2 3 2 3 2 2 2 3 2 3 2 2 3 3 2 3 2 3 3 2 7 6 6 6 6 6 6 6 6 6 7 2 2 2 2 8 8 2 2 3 2 3 3 2 2 1 2 2 2 2 2 3 3 3 8 2 3 2 3 2 2 3 2 2 2 2 4
4 3 3 2 3 2 2 8 2 3 2 3 0 2 3 2 2 3 3 2 2 3 2 3 2 2 3 2 2 3 2 3 3 2 8 2 3 2 3 2 3 2 2 2 3 2 2 3 3 3 2 2 3 2 7 6 6 6 6 6 6 6 7 2 3 2 2 3 3 3 3 2 3 3 3 3 3 3 1 2 2 2 3 3 2 2 2 2 3 2 2 2 2 3 3 8 2 2 2 4
4 3 2 3 3 2 2 3 3 2 2 2 0 3 2 3 3 2 3 2 2 2 2 3 3 8 2 2 3 2 2 2 3 2 3 3 3 2 3 3 2 3 2 3 3 3 2 2 2 2 2 3 2 2 3 7 7 7 6 7 7 7 3 3 3 3 2 2 3 3 2 2 3 2 2 3 3 3 0 8 3 3 2 2 3 3 2 3 2 3 3 3 3 3 2 3 2 2 3 4
4 2 3 3 2 3 8 8 3 3 3 3 0 3 2 2 2 3 3 2 8 2 3 3 2 3 2 3 2 2 2 7 2 2 3 2 8 2 3 3 2 3 2 2 3 2 2 2 3 2 3 3 3 8 3 3 2 3 7 2 3 2 2 3 3 8 2 2 3 3 2 3 2 3 3 3 2 2 1 2 2 2 2 3 3 3 2 3 3 2 3 3 3 3 3 2 2 2 3 4
4 2 3 2 3 3 3 8 3 2 2 8 1 3 3 3 2 2 3 2 2 3 2 2 3 3 3 3 7 7 7 6 7 7 7 2 2 3 3 2 2 3 3 3 2 3 3 3 2 2 3 3 2 3 2 2 2 3 2 2 3 3 2 2 2 2 2 2 2 8 3 3 2 3 3 2 2 3 0 3 2 2 2 3 3 3 3 2 2 2 2 3 3 2 3 2 3 3 3 4
4 2 3 3 3 3 3 2 2 2 3 3 0 3 3 2 2 2 2 3 2 3 2 2 8 2 2 7 6 6 6 6 6 6 6 7 2 3 2 2 2 8 3 3 3 3 2 2 3 3 2 3 3 2 2 3 3 3 3 2 3 2 3 3 3 3 2 2 3 2 3 2 2 2 2 2 2 2 1 3 8 3 2 3 2 2 2 2 2 3 3 2 3 2 8 3 2 2 3 4
4 3 3 3 2 2 2 3 2 3 2 2 0 8 2 8 2 2 3 3 3 3 2 8 2 2 7 6 6 6 6 6 6 6 6 6 7 8 2 2 2 3 2 2 3 3 3 3 3 3 3 8 2 8 2 3 2 8 2 2 3 2 3 2 2 3 2 3 2 2 2 2 3 2 3 3 3 3 0 2 2 3 2 3 2 2 3 2 3 3 3 3 2 3 2 8 3 8 3 4
4 8 3 2 3 2 2 2 3 3 3 3 1 2 2 8 2 2 3 3 2 2 3 2 2 7 6 6 6 6 6 6 6 6 6 6 6 8 3 2 3 2 3 3 3 3 8 2 3 2 2 2 3 2 3 2 8 3 3 2 2 2 3 2 3 2 2 3 3 3 2 2 2 3 2 3 3 2 1 3 2 3 2 2 2 2 2 2 2 2 3 3 2 3 3 2 2 3 3 4
4 2 3 2 2 3 2 3 2 2 2 3 1 2 3 2 2 2 3 3 3 2 2 3 3 7 6 6 6 6 6 6 6 6 6 6 6 7 3 2 3 2 3 2 3 3 2 3 2 3 3 8 3 3 2 2 2 3 3 3 2 2 2 2 3 2 2 3 3 2 3 3 2 2 2 2 3 3 0 2 3 3 3 3 2 2 2 3 2 2 2 3 2 2 3 3 2 2 3 4
4 2 2 2 2 3 3 2 3 3 3 2 0 3 3 2 3 3 3 2 3 2 3 2 2 7 6 6 6 6 6 6 6 6 6 6 6 7 2 3 8 3 3 3 3 3 2 3 3 2 2 3 3 8 3 3 3 2 3 2 3 3 2 3 3 2 2 2 2 3 3 3 3 3 2 2 3 3 1 2 3 2 3 3 2 3 3 3 2 3 3 2 3 2 3 3 2 2 2 4
4 2 3 3 2 3 3 8 2 2 3 3 0 2 2 2 3 3 3 4 3 2 2 3 8 6 6 6 6 6 6 6 6 6 6 6 6 6 7 3 3 2 2 3 2 2 3 3 8 3 2 2 2 3 2 2 8 3 3 2 3 3 3 2 3 2 8 3 2 2 3 3 3 2 2 3 3 3 0 2 3 3 2 3 8 2 3 8 2 2 3 3 3 2 2 2 3 3 2 4
4 3 3 3 2 3 2 3 8 2 2 3 1 3 2 2 2 4 4 5 5 5 2 2 3 7 6 6 6 6 6 6 6 6 6 6 6 8 3 2 3 2 2 2 8 2 2 2 2 3 3 3 2 3 2 2 3 3 3 2 2 2 2 2 3 2 2 2 2 3 2 2 2 3 3 2 2 2 0 3 3 8 3 2 2 3 3 2 3 3 2 2 2 2 2 3 3 3 3 4
4 2 3 2 2 2 2 3 3 2 9 9 1 9 9 3 2 5 5 4 5 5 2 2 3 7 6 6 6 6 6 6 6 6 6 6 6 7 2 3 3 3 2 3 2 2 3 3 3 3 3 3 2 3 2 2 3 3 3 8 3 2 2 2 3 2 3 3 8 3 3 2 2 3 2 2 2 3 1 3 2 2 7 2 2 2 2 2 2 3 3 2 2 3 3 8 2 3 2 4
4 3 3 8 3 2 2 3 8 2 9 9 1 0 0 1 0 0 1 1 0 1 1 1 0 0 6 6 6 6 6 6 6 6 6 6 6 0 0 1 1 1 1 1 0 0 0 0 1 0 1 1 0 0 0 1 1 1 0 0 1 0 0 0 1 0 1 0 0 0 1 0 1 0 1 1 0 0 0 7 7 7 6 7 7 7 2 3 3 3 3 3 3 2 3 8 3 3 3 4
4 2 3 3 3 3 3 2 2 2 9 9 0 0 1 0 0 1 0 1 0 0 0 0 0 0 0 6 6 6 6 6 6 6 6 6 1 1 0 0 0 1 0 0 1 1 1 0 1 1 0 1 0 0 0 0 1 1 1 1 0 0 0 1 0 0 0 0 0 0 0 0 1 1 0 0 1 0 1 6 6 6 6 6 6 6 7 2 3 3 3 3 2 3 3 8 2 3 2 4
4 2 2 2 8 3 8 3 3 3 9 9 1 9 9 2 3 4 4 4 5 4 2 2 2 2 2 7 6 6 6 6 6 6 6 7 2 2 8 3 2 3 2 3 3 3 3 3 2 2 2 3 3 2 2 3 2 3 2 3 3 2 3 2 3 3 3 3 3 2 2 3 3 2 2 2 2 7 6 6 6 6 6 6 6 6 6 7 3 3 2 2 3 3 3 2 3 3 3 4
4 2 2 3 2 2 3 2 3 2 9 9 1 9 9 3 3 2 2 5 2 2 3 2 2 3 2 3 7 7 7 6 7 7 8 3 3 2 8 3 2 8 3 2 2 2 3 2 3 2 3 3 3 3 2 3 3 3 3 2 2 2 3 3 3 2 8 3 2 3 2 2 2 2 3 2 7 6 6 6 6 6 6 6 6 6 6 6 7 3 2 2 3 3 2 2 3 2 3 4
4 2 2 2 8 8 8 3 2 3 2 3 1 2 2 3 3 2 2 3 3 2 3 2 3 3 3 3 3 3 3 7 3 2 3 2 3 2 2 2 2 3 2 3 2 3 2 3 3 3 2 3 3 2 3 3 3 2 3 3 3 2 2 3 2 3 2 2 3 3 3 3 2 2 2 2 7 6 6 6 6 6 6 6 6 6 6 6 7 2 3 2 3 3 2 2 3 2 3 4
4 2 2 2 3 3 2 2 2 2 2 2 1 3 2 3 3 3 3 2 3 3 2 2 3 2 3 2 3 2 2 2 2 2 3 2 3 2 2 3 2 3 3 3 2 2 3 3 3 8 2 3 2 3 3 3 2 3 2 2 2 2 8 3 3 3 3 8 2 2 3 2 2 2 8 3 7 6 6 6 6 6 6 6 6 6 6 6 7 2 2 2 3 2 8 2 3 2 3 4
4 2 2 2 2 2 2 2 3 3 2 2 1 3 2 3 3 2 2 3 3 3 2 3 3 2 3 2 3 2 2 3 2 3 8 2 3 3 2 3 2 2 3 3 2 3 2 2 3 2 3 2 3 3 2 8 3 3 3 3 2 3 3 3 3 3 3 8 2 3 3 3 3 3 3 7 6 6 6 6 6 6 6 6 6 6 6 6 6 7 3 3 2 2 2 2 2 3 2 4
4 2 3 2 2 3 3 2 3 3 3 2 1 2 3 8 3 3 2 2 2 3 2 3 2 8 2 2 2 3 2 2 3 3 2 2 3 2 3 8 2 3 3 3 2 2 2 2 8 2 2 3 2 3 2 3 3 2 3 3 3 3 2 2 2 3 3 3 2 2 3 2 3 2 2 3 7 6 6 6 6 6 6 6 6 6 6 6 7 3 3 2 2 2 8 3 2 2 2 4
4 2 8 3 8 2 2 2 2 3 3 2 1 3 2 3 3 2 3 3 2 2 2 2 2 2 2 3 2 2 2 2 3 2 2 3 2 2 2 2 3 2 2 2 2 3 2 2 2 3 3 2 2 2 2 3 2 3 3 3 2 2 2 3 3 3 2 8 3 2 2 3 3 2 3 2 7 6 6 6 6 6 6 6 6 6 6 6 7 2 3 2 3 2 2 2 2 2 3 4
4 3 8 3 3 3 2 3 3 2 2 3 0 2 3 3 3 2 2 2 3 3 2 3 3 3 3 8 8 3 3 2 2 3 2 2 3 2 3 3 3 2 3 2 3 3 2 3 2 3 3 3 3 2 3 3 2 3 2 3 3 2 2 8 2 2 3 3 3 3 8 8 3 2 3 3 7 6 6 6 6 6 6 6 6 6 6 6 7 3 2 2 3 3 3 3 2 3 2 4
4 2 2 2 8 2 3 2 2 3 2 3 0 3 3 2 8 3 2 3 3 2 3 3 3 3 3 2 3 3 3 3 2 8 2 2 2 2 2 3 3 3 8 3 2 3 2 3 3 2 3 3 3 2 2 2 3 3 8 3 3 3 3 3 2 3 3 3 3 3 2 3 3 8 3 8 2 7 6 6 6 6 6 6 6 6 6 7 3 3 3 2 3 2 3 3 2 3 3 4
4 2 3 3 2 3 3 3 2 2 3 2 0 8 3 3 3 2 2 3 3 3 3 3 3 3 2 3 2 3 3 3 3 3 8 2 3 2 3 2 3 3 3 2 3 2 3 2 3 3 3 3 3 3 2 3 3 3 2 3 8 2 2 2 3 2 2 2 2 3 2 2 2 3 2 2 2 8 1 6 6 6 6 6 6 6 7 2 3 8 3 3 3 2 2 3 3 2 3 4
4 3 3 8 2 2 3 2 2 3 2 8 0 2 3 2 3 2 3 2 3 3 2 3 2 3 3 2 2 2 2 2 2 8 2 2 3 2 2 2 2 3 3 3 2 3 2 3 3 2 8 2 2 2 3 2 3 2 2 3 3 3 3 2 3 2 3 3 3 3 3 3 8 2 3 3 3 2 0 7 7 7 6 7 7 7 3 8 8 3 2 2 2 3 3 3 2 3 3 4
4 2 2 3 2 2 2 2 3 3 2 8 0 2 2 2 2 3 3 2 3 2 5 2 2 3 3 2 3 2 3 2 2 8 2 8 8 2 2 3 3 2 2 2 2 3 3 2 2 3 2 3 2 3 3 3 3 2 2 3 2 2 2 2 2 2 2 3 2 8 3 3 2 2 2 3 2 2 0 2 2 2 7 8 2 3 3 2 3 2 2 3 2 2 3 2 3 3 2 4
4 3 2 3 3 3 2 2 8 2 2 3 1 3 3 3 2 3 2 3 5 5 4 5 4 2 3 2 3 2 2 8 8 3 8 3 8 8 3 8 3 2 3 2 3 2 2 3 2 2 2 2 8 2 3 2 2 3 3 3 2 2 2 2 3 3 2 3 3 3 8 2 8 3 2 3 3 3 0 3 2 3 3 3 2 3 3 3 3 3 3 2 2 3 3 2 2 3 2 4
4 3 2 2 3 3 2 2 3 2 2 8 0 2 3 2 2 2 3 2 5 5 4 4 5 3 3 2 2 2 2 3 8 8 3 8 8 8 8 8 8 2 3 3 3 3 3 2 2 2 3 2 3 3 3 3 3 2 3 2 3 3 8 2 3 2 3 2 2 3 2 3 2 2 8 2 3 2 1 2 3 2 2 8 3 8 3 2 3 2 3 2 2 3 3 2 8 2 2 4
4 3 3 2 3 8 2 2 3 2 2 2 1 3 3 2 2 3 3 4 5 5 4 4 5 4 2 3 2 3 2 2 8 8 3 8 8 8 8 8 8 8 3 2 3 2 3 2 3 3 2 2 2 3 2 2 2 2 2 2 2 2 3 2 3 2 2 3 3 3 2 3 2 3 3 8 3 2 1 3 3 2 2 2 3 2 3 2 2 2 2 3 2 2 2 8 2 2 3 4
4 3 2 2 2 3 3 2 3 2 3 2 0 3 2 3 3 3 2 2 4 5 4 5 5 2 2 2 2 2 2 8 8 8 8 8 2 3 3 8 8 3 3 8 8 8 2 8 3 2 2 3 3 2 3 3 2 3 3 8 2 2 2 3 3 2 2 3 3 2 2 2 3 3 3 3 3 3 1 3 3 2 2 3 3 2 2 3 3 3 2 2 2 3 2 2 3 2 3 4
4 3 3 2 2 2 2 2 3 9 9 9 1 9 2 2 3 3 2 3 5 5 4 4 5 3 3 2 3 3 7 3 2 8 8 2 8 8 8 8 8 8 8 8 8 8 8 8 8 8 3 2 8 3 3 2 2 2 2 3 3 3 3 3 3 2 2 3 2 2 3 2 3 2 2 3 3 3 1 2 2 8 3 3 3 3 2 2 2 2 3 2 3 3 2 3 2 3 3 4
4 2 2 2 3 3 2 3 3 9 9 9 0 9 9 9 9 3 2 5 5 4 4 4 4 4 2 2 3 7 7 3 8 8 8 8 2 2 8 8 8 8 8 8 3 8 8 8 8 2 8 8 8 8 8 2 3 2 2 8 3 2 3 3 2 2 3 2 2 2 3 2 2 2 3 3 2 2 0 2 3 3 2 9 9 9 9 9 2 2 2 2 2 3 3 2 2 2 3 4
4 3 2 2 3 2 3 3 2 9 9 0 0 0 1 0 0 0 1 0 0 0 0 0 1 1 0 1 0 1 0 0 0 0 1 0 1 1 1 0 1 1 1 1 0 1 0 1 1 1 0 0 0 0 1 1 0 1 0 0 0 1 1 0 1 0 0 1 0 0 1 1 1 1 1 0 1 1 0 3 2 2 2 9 9 9 9 9 2 2 3 3 2 2 3 2 2 3 3 4
4 3 3 2 3 3 2 2 3 9 9 1 1 1 1 0 1 0 0 1 1 0 1 1 1 0 0 0 1 0 1 0 0 1 0 0 0 1 0 0 1 1 1 0 1 1 1 0 1 0 0 1 0 1 1 0 1 0 1 0 0 1 0 1 0 0 1 1 1 1 1 0 1 1 1 0 1 1 1 0 1 1 0 1 1 0 9 9 2 2 2 2 2 8 3 2 8 3 8 4
4 3 2 3 3 3 3 2 2 9 9 0 9 9 9 9 9 2 5 4 4 4 0 4 4 5 5 7 7 7 7 7 8 8 8 8 8 3 8 8 8 2 8 8 8 8 2 8 8 8 8 8 8 8 8 8 3 2 8 8 8 8 3 2 3 2 2 2 3 2 3 3 2 3 2 3 8 3 2 3 2 3 2 9 9 9 9 9 3 2 3 2 3 2 2 3 2 2 2 4
4 2 2 3 3 3 2 3 2 2 3 1 0 1 0 0 1 0 0 0 0 1 0 4 4 4 5 5 7 7 7 7 8 8 8 8 8 8 2 3 8 8 8 8 8 8 8 3 2 2 2 8 8 8 8 8 3 3 8 8 8 8 8 2 2 2 2 3 3 2 3 2 3 3 2 2 3 2 2 2 3 3 2 9 9 9 9 9 2 2 8 2 2 2 3 2 2 3 2 4
4 3 2 3 3 3 3 2 2 2 2 3 2 2 2 2 3 3 5 5 5 5 5 4 5 4 5 7 7 7 5 7 7 8 8 8 8 2 8 8 8 3 3 8 8 8 8 3 8 8 8 2 8 3 8 3 3 3 2 8 2 2 8 3 2 2 2 3 3 3 2 8 3 2 2 2 3 2 2 2 3 3 2 3 2 3 2 2 3 3 8 3 2 2 3 2 8 3 2 4
4 3 2 2 3 3 2 3 2 3 3 3 3 3 3 3 3 3 4 4 4 5 4 4 4 4 5 7 7 7 7 7 7 3 8 2 8 8 3 8 8 8 2 2 2 8 8 8 8 8 8 8 8 8 8 2 8 8 8 8 8 8 8 8 8 3 3 2 3 2 2 3 3 3 2 3 2 3 3 2 2 2 3 3 3 3 3 2 2 2 3 3 2 3 2 3 3 3 3 4
4 2 3 2 3 2 2 3 2 3 2 3 3 2 2 2 2 3 5 5 4 4 5 5 4 5 4 7 7 7 7 7 7 8 8 8 2 8 8 2 3 8 8 3 8 2 8 3 3 8 8 8 8 8 8 8 8 8 3 8 8 8 2 8 8 8 3 3 3 2 3 3 3 2 3 2 2 3 2 2 2 2 2 3 3 2 3 3 2 3 2 3 3 3 3 2 2 3 2 4
4 2 2 2 2 2 3 3 3 2 2 2 3 3 2 2 3 3 2 4 5 4 5 4 4 5 7 7 7 7 7 4 7 7 8 8 2 2 8 2 8 8 8 8 8 8 8 8 8 3 8 8 2 8 3 8 3 2 8 3 8 8 2 2 8 8 8 3 2 3 2 2 3 3 3 8 7 3 3 3 2 3 3 3 2 3 3 2 8 3 2 3 2 3 2 2 3 3 2 4
4 3 2 2 2 3 3 2 2 3 2 3 3 3 3 2 2 2 3 3 2 3 4 3 7 7 7 7 7 7 7 7 7 7 8 8 8 3 8 3 8 8 8 8 8 8 2 2 8 8 8 8 8 8 2 8 8 8 2 8 8 8 8 2 8 3 8 3 2 3 3 3 8 7 8 7 6 7 7 7 2 3 3 2 3 8 2 2 3 2 3 3 2 2 2 2 2 3 2 4
4 2 2 3 3 2 3 3 3 3 3 2 2 3 3 2 2 3 8 3 2 8 3 2 7 7 7 7 7 7 4 4 7 7 8 8 8 8 2 3 8 8 2 8 8 2 8 8 8 8 8 8 8 8 8 3 3 2 8 8 2 3 2 2 8 8 8 2 3 3 3 3 7 6 6 6 6 6 6 6 7 3 3 3 2 3 2 3 2 2 8 2 3 2 8 3 2 3 8 4
4 3 3 2 3 2 2 3 2 3 3 2 3 3 3 3 3 3 3 8 3 2 2 3 7 7 7 7 4 7 7 7 4 7 5 2 2 3 8 8 8 8 2 8 8 8 2 8 8 8 8 8 3 8 8 3 8 8 8 8 8 8 3 8 3 8 3 2 3 3 2 7 6 6 6 6 6 6 6 6 6 7 2 3 2 8 3 2 3 2 3 3 3 3 3 3 3 3 3 4
4 2 3 2 3 2 2 2 2 3 3 3 3 2 3 3 3 2 2 3 2 3 2 2 7 7 7 5 7 7 4 7 7 7 7 3 8 8 8 8 8 3 3 3 8 2 2 8 8 8 2 8 8 2 3 3 8 8 2 2 8 8 8 2 8 8 8 2 8 8 7 6 6 6 6 6 6 6 6 6 6 6 7 2 3 3 3 3 8 3 2 2 2 8 3 2 2 3 3 4
4 3 2 2 3 3 2 2 3 2 2 2 3 8 2 2 3 2 2 3 3 3 2 2 7 7 7 7 7 7 7 7 7 7 7 3 8 2 8 8 3 8 8 8 8 8 8 8 3 8 8 8 8 8 2 8 2 8 8 8 8 8 8 3 8 8 8 8 2 7 6 6 6 6 6 6 6 6 6 6 6 6 6 7 3 2 3 3 3 3 2 3 3 2 3 8 2 2 3 4
4 2 2 3 2 2 3 3 2 3 2 8 2 3 3 2 3 2 2 3 8 3 3 2 7 7 7 7 7 7 7 7 7 7 5 7 2 8 8 8 8 8 8 8 8 8 8 8 8 3 8 8 8 8 2 3 8 3 3 8 8 2 8 8 8 8 8 8 3 7 6 6 6 6 6 6 6 6 6 6 6 6 6 7 3 2 3 3 2 3 2 2 3 3 3 3 2 2 2 4
4 3 3 2 3 3 3 2 8 3 2 3 3 2 3 2 3 2 2 3 2 2 2 3 7 7 7 7 7 7 7 7 7 5 7 7 8 3 8 8 3 8 2 8 3 8 8 8 8 8 2 8 8 3 8 8 8 2 2 8 3 8 2 8 8 2 8 8 8 8 6 6 6 6 6 6 6 6 6 6 6 6 6 7 3 2 2 2 3 3 2 2 3 2 3 3 2 3 2 4
4 3 3 2 3 2 2 3 3 3 8 2 2 2 3 2 2 3 3 3 2 8 3 2 7 7 7 7 7 7 7 7 7 7 7 7 2 8 8 8 8 8 8 8 8 8 2 8 2 8 2 8 8 8 3 8 3 2 8 8 2 3 8 8 8 8 8 3 8 6 6 6 6 6 6 6 6 6 6 6 6 6 6 6 7 2 2 3 3 3 3 2 8 2 2 2 8 3 3 4
4 3 2 3 3 3 3 3 2 3 2 3 8 2 3 2 3 2 2 2 2 3 3 2 7 7 7 7 7 7 7 7 7 7 7 7 7 8 8 2 8 8 3 8 3 3 8 8 8 8 8 3 8 8 8 8 8 8 8 2 8 8 3 3 2 8 8 8 2 8 6 6 6 6 6 6 6 6 6 6 6 6 6 7 3 3 3 3 3 2 3 3 2 3 2 3 3 2 2 4
4 3 8 3 2 2 2 3 2 3 3 2 3 3 3 2 3 3 2 3 2 3 2 2 7 4 7 7 5 7 7 7 7 7 7 7 7 8 8 2 8 8 8 8 8 8 8 3 8 8 8 8 8 3 8 8 2 2 3 8 8 8 8 3 3 2 8 3 8 8 6 6 6 6 6 6 6 6 6 6 6 6 6 7 3 3 2 3 3 3 2 2 3 2 3 2 8 3 2 4
4 3 3 2 2 2 3 3 3 3 3 2 3 2 3 2 2 2 3 2 2 3 2 2 7 7 7 7 7 7 7 5 7 7 7 4 7 8 2 8 8 3 2 8 2 8 8 8 2 8 2 8 8 8 3 8 8 8 8 8 2 8 8 2 2 8 8 8 8 7 6 6 6 6 6 6 6 6 6 6 6 6 6 7 3 3 3 2 2 3 3 3 3 2 3 3 2 3 8 4
4 3 3 3 3 2 3 2 2 2 8 2 3 2 2 2 2 3 3 2 3 3 2 3 7 7 5 7 5 7 7 7 7 7 7 7 7 8 8 3 8 2 8 8 8 8 8 8 8 2 3 8 8 8 8 2 8 8 2 8 2 8 8 8 8 8 8 3 8 8 8 6 6 6 6 6 6 6 6 6 6 6 7 3 3 2 2 8 3 3 3 2 2 3 2 3 3 2 3 4
4 3 2 2 8 8 3 3 3 2 3 3 3 2 2 3 3 3 8 3 3 8 3 3 7 7 7 7 7 7 7 7 4 7 7 7 7 7 8 8 8 3 8 8 8 8 2 8 8 8 8 8 8 8 8 8 8 3 3 8 3 3 8 8 3 8 8 8 3 8 3 7 6 6 6 6 6 6 6 6 6 7 3 2 2 3 3 3 3 3 3 3 2 2 3 3 3 2 3 4
4 3 3 3 2 3 3 2 2 8 3 3 2 2 2 3 3 3 3 3 2 3 3 2 7 7 7 7 7 7 7 7 7 7 5 7 4 7 8 8 8 8 8 8 8 8 8 8 8 8 8 8 8 8 8 8 2 8 2 8 3 8 3 8 8 8 8 8 8 2 8 2 8 6 6 6 6 6 6 6 7 3 2 3 3 3 3 8 2 2 3 2 3 3 3 2 2 3 2 4
4 3 2 3 3 2 2 2 2 3 3 2 3 2 2 2 2 3 3 3 2 2 2 2 7 7 7 4 7 5 5 7 7 7 7 7 7 7 8 8 2 3 8 2 8 8 8 3 8 2 8 2 8 8 8 3 3 3 2 2 8 8 3 8 8 2 8 8 3 8 3 8 8 8 7 7 6 7 8 8 2 3 2 3 2 3 2 2 2 3 3 2 8 3 2 2 2 3 3 4
4 3 3 3 8 3 3 2 2 2 3 2 3 3 2 3 3 3 3 3 2 2 2 2 7 7 7 7 7 7 7 7 7 7 7 7 7 7 7 8 8 2 8 3 8 8 3 8 8 8 8 8 8 8 2 3 3 8 3 8 8 8 8 8 2 8 8 8 8 8 8 8 8 8 8 3 8 8 8 8 8 2 2 3 2 2 2 3 2 2 2 2 3 2 2 2 2 2 2 4
4 3 3 2 2 2 2 3 2 2 3 3 3 8 3 2 2 2 2 2 2 2 2 3 7 7 7 7 7 7 7 5 7 7 7 7 7 7 7 3 8 8 2 8 2 3 8 8 8 8 2 2 3 2 8 8 8 2 8 8 8 8 8 2 2 2 3 8 3 8 8 2 8 8 2 8 3 8 8 2 8 8 2 8 2 8 8 2 3 3 2 3 2 2 3 2 3 3 2 4
4 3 8 3 2 2 2 3 3 2 2 3 2 2 3 8 3 3 3 3 3 3 3 3 7 7 7 7 7 7 7 7 7 7 7 7 7 7 7 8 2 8 8 8 2 8 8 8 8 8 8 2 8 8 8 8 8 3 8 3 8 2 8 8 8 3 8 8 2 8 3 3 8 8 8 8 3 8 8 8 8 8 8 3 3 3 8 2 3 2 2 2 2 2 3 3 2 3 2 4
4 4 4 4 4 4 4 4 4 4 4 4 4 4 4 4 4 4 4 4 4 4 4 4 4 4 4 4 4 4 4 4 4 4 4 4 4 4 4 4 4 4 4 4 4 4 4 4 4 4 4 4 4 4 4 4 4 4 4 4 4 4 4 4 4 4 4 4 4 4 4 4 4 4 4 4 4 4 4 4 4 4 4 4 4 4 4 4 4 4 4 4 4 4 4 4 4 4 4 4
